的	d_
一	y_
是	s_
在	z_
不	b_
了	l_
有	j_
這	v_
個	g_
我	u_
他	t_
會	w_
發	f_
你	n_
才	c_
係	h_
愛	i_
跑	p_
阿	a_
啊	q_
掛	x_
唉	e_
哦	o_
嗯	r_
和	wo_
人	yf_
中	zs_
大	dv_
為	w2
上	s5
國	xp_
以	yi_
要	y4
地	dz_
時	si_
來	l5
用	ys_
生	sj_
到	d3
作	zp_
出	co_
就	z2
分	ff_
對	dx_
成	s;_
可	ho_
年	nn_
動	ds_
同	ts_
也	y3
能	n4
下	ha_
過	xo_
說	sd_
產	cj_
行	hj_
面	mn_
後	hb_
多	do_
定	d;_
學	hp_
法	fc_
所	so_
得	dq_
十	sm_
三	sh_
進	vp_
等	dg_
部	bu_
電	dn_
力	lk_
水	ux_
高	gu_
都	du_
二	ji_
理	lz_
起	hz_
小	s3
長	ct_
實	uc_
加	ga_
兩	lt_
還	w3
當	dw_
使	sl_
點	dm_
從	cs_
業	yz_
本	br_
去	hx_
好	hu_
應	j;_
開	hy_
合	hm_
其	kz_
前	cn_
外	ry_
天	tn_
四	sz_
日	yc_
那	na_
事	ui_
平	p;_
全	cr_
裏	lx_
表	bq_
與	yy_
關	xj_
各	gp_
新	sf_
內	ny_
數	su_
正	z;_
心	sg_
看	he_
又	j3
比	b3
或	wh_
但	dj_
第	dl_
向	ht_
此	ci_
沒	m2
條	tq_
只	zi_
結	gi_
問	mf_
無	mu_
很	hf_
最	zx_
代	dy_
想	st_
五	rr_
入	ym_
次	ii_
品	bf_
活	wt_
及	km_
求	kb_
老	lu_
頭	tb_
邊	bn_
少	s4
圖	tu_
接	zz_
將	zt_
別	bi_
她	ta_
手	sb_
農	ns_
幾	gz_
九	gb_
區	kx_
強	kt_
放	f5
被	bz_
做	zu_
先	sn_
則	zq_
回	wx_
給	km2
處	cy_
光	xw_
七	cc_
壓	ec_
極	gk_
共	gs_
權	kr_
轉	zr_
更	g2
風	fs_
打	da_
白	bh_
速	cd_
花	fa_
場	ct2
真	zf_
萬	mj_
每	mx_
目	md_
達	dc_
走	zb_
鬥	db_
八	bc_
名	m;_
確	kp_
信	sp_
話	wa_
整	v;_
集	zv_
步	bu2
群	qf_
段	dr_
拉	lv_
林	lg_
叫	gq_
裝	zw_
算	sr_
非	fz_
連	ln_
難	nj_
近	kf_
列	li_
團	tr_
太	tv_
寫	se_
快	f3
眼	rj_
王	ww_
片	pn_
卻	kk_
識	uk_
火	fo_
局	gd_
紅	hs_
聽	t;_
該	gy_
鐵	ti_
隨	cx_
死	uz_
講	gw_
呢	ni_
女	nx_
推	tx_
談	th_
望	mw_
批	pl_
落	lp_
幫	bw_
破	po_
排	pv_
減	gh_
怎	zg_
均	xf_
差	ca_
費	fl_
緊	g5
早	z5
服	fd_
食	sk_
護	wu_
某	mb_
黑	hq_
送	ss_
吃	hk_
春	cp_
跟	gf_
曾	cg_
創	cw_
抗	kw_
考	hn_
壞	wv_
未	mz_
換	wr_
留	lb_
站	zh_
錢	in_
副	fu_
令	l;_
請	c;_
超	cq_
讓	yt_
找	zn_
敵	dk_
塊	f4
錯	io_
頻	pf_
念	nm_
靠	kn_
皮	pz_
若	yk_
搞	gn_
核	hc_
吧	ba_
普	pu_
銀	rf_
語	jy_
缺	kd_
嗎	ma_
急	gm_
脫	td_
沙	sa_
獲	wp_
著	zk_
製	zl_
亂	lr_
殺	sc_
寧	n;_
讀	dd_
班	bj_
句	gx_
擔	dh_
誰	s2
臉	lm_
背	bx_
買	mv_
怕	ph_
薄	bp_
末	mz2
娘	nt_
盟	mg_
屋	ed_
掉	d4
呀	ea_
齊	cl_
款	fr_
永	w;_
滅	gh2
蓋	ky_
域	wk_
潤	yp_
腦	nu_
歐	eb_
惡	ep_
暗	eg_
卡	ka_
借	ze_
灰	fx_
尺	ck_
驚	g;_
旁	pw_
托	tp_
寶	uc2
揭	ki_
男	nh_
並	b;_
插	cv_
岸	re_
啦	la_
肯	hg_
黎	ll_
夢	ms_
啟	kl_
扎	zc_
藍	lh_
弄	ls_
怪	xv_
夾	gv_
窮	ks_
牙	ra_
拍	ph2
挖	wc_
喝	hw_
奶	nv_
爹	de_
碰	ps_
哭	hd_
仲	z3
銳	yx_
撥	bt_
票	pq_
騰	tg_
貼	tz_
闊	ft_
摸	mo_
偶	rb_
吉	gc_
爛	lj_
簽	cm_
烏	nq_
暖	nr_
隙	qk_
狂	qw_
憑	pg_
鳥	nq2
添	tm_
棒	pj_
埋	m5
逼	bk_
勸	hr_
咬	rn_
返	fj_
虧	ql_
框	qj_
哩	le_
偽	rl_
嘆	tj_
轟	xg_
撲	pp_
陪	px_
捉	zd_
郎	lw_
諾	np_
騎	ke_
慘	ch_
潑	pt_
霍	fp_
餓	ro_
吞	tf_
矮	el_
歇	hi_
宏	wg_
刮	xc_
匹	pc_
爽	sw_
蹲	dp_
捧	bs_
囊	nw_
吟	rg_
趁	cf_
晒	sv_
誇	qa_
喲	yo_
喇	l2
甩	lc_
踢	tk_
裹	lx2
啡	fe_
咳	kc_
聊	lq_
劈	pk_
迄	rc_
踩	jv_
賺	zj_
揀	gj_
咯	lo_
撇	pi_
墩	df_
唔	mm_
嗚	ma2
箍	ku_
嚙	ri_
匿	nk_
覓	mk_
廿	ja_
呃	eh_
們	mro_
於	yyy_
主	zyy_
工	gsm_
子	zin_
種	zs3
而	yim_
方	fwy_
民	mfr_
經	g;v_
之	zii_
度	dui_
家	gaj_
如	yyv_
化	fao_
自	zih_
物	mch_
現	ynb_
量	lta_
體	tlb_
機	gzd_
重	csh_
把	baq_
性	s;p_
它	taj_
因	yfw_
制	zlh_
由	ybl_
些	sey_
然	ynb2
政	z;m_
社	sei_
義	yit_
相	std_
間	gja_
樣	ytd_
線	snv_
反	fjh_
明	m;2
原	yrj_
利	lzh_
質	zch_
氣	hzo_
道	duy_
命	m;o_
變	bn3
解	gvn_
意	yiy_
建	gnn_
月	yd4
公	gsc_
軍	xfb_
情	c;p_
者	zej_
立	lvy_
已	yis_
通	tsy_
提	tlq_
直	zkj_
題	tla_
黨	dwf_
展	zns_
果	xow_
料	lqf_
象	zto_
員	yrr_
革	ght_
位	wlo_
常	stf_
文	mfy_
總	zsv_
式	ski_
設	ciy_
管	grh_
特	dqh_
件	gno_
基	gzt_
流	lbe_
路	lu5
級	kmv_
山	sju_
統	tsv_
知	zio_
組	zuv_
見	gn3
計	gly_
角	gpn_
期	kzt_
根	gfd_
論	lpy_
運	wfy_
指	ziq_
決	kde_
西	slm_
必	bip_
戰	znr_
任	ygy_
取	cxs_
據	gxq_
調	tqy_
隊	dxn_
南	nhj_
色	skn_
門	mra_
即	zka_
保	buo_
治	zie_
北	bql_
造	zuy_
百	bhm_
熱	sdy_
海	hye_
口	hbr_
東	dsd_
器	hzr_
世	slp_
金	ggc_
增	zgg_
爭	zjb_
濟	zle_
思	siw_
術	soh_
交	gny_
受	sbb_
幹	gej_
聯	lrs_
認	j;j_
六	ldy_
收	sbv_
證	z;y_
改	gy5
清	c;e_
志	zig_
美	mzt_
己	yis2
再	zyo_
單	djr_
切	cip_
教	gnj_
帶	dv2
安	eej_
身	sfh_
車	cej_
例	llo_
務	mun_
具	gxb_
至	zim_
積	zkh_
示	sim_
聲	s;2
報	bug_
完	yrj2
類	lxf_
離	lz3
華	wat_
科	foh_
傳	cro_
張	ztn_
馬	mas_
米	mlf_
採	cyq_
空	hsj_
元	yrm_
況	few_
今	ggo_
土	tug_
許	hxy_
石	skm_
廣	xwi_
且	ceb_
記	gzy_
需	sxm_
研	ynm_
界	gvw_
律	loh_
究	gbj_
觀	grt_
越	ydg_
織	zkv_
影	y;a_
低	dlo_
持	ciq_
音	ygy2
眾	zsw_
系	hlh_
書	sy4
容	ysj_
際	zln_
驗	yms_
斷	trv_
深	sge_
須	sxh_
礦	qwm_
千	cnh_
省	sjf_
技	gzq_
半	brf_
青	c;q_
辦	bjy_
習	zvs_
便	bno_
響	htv_
約	ykv_
般	brh_
史	sil_
感	ggi_
勞	luf_
往	wwh_
酸	srm_
稱	c;h_
克	hqj_
何	hoo_
除	cxn_
消	sqe_
構	kbd_
甚	sgt_
精	z;f_
歷	lkm_
周	zbb_
什	sgo_
號	hur_
族	zdy_
維	wlv_
劃	whl_
選	sry_
標	bqd_
存	crk_
候	hbo_
親	cfy_
毛	muh_
查	cad_
斯	sit_
院	yrn_
型	y;m_
按	eeq_
格	ghd_
養	ytt_
易	yia_
置	ziw_
派	pve_
層	cgs_
始	civ_
狀	zwv_
專	zrj_
育	ydy_
廠	cwi_
參	chi_
屬	sds_
圓	yrw_
包	bnp_
住	zyo2
滿	mre_
縣	yrb_
照	zqa_
輕	h;j_
引	yfn_
細	slv_
嚴	ymr_
底	dli_
首	sbt_
液	yke_
官	grj_
病	b;k_
失	sch_
蘇	sut_
配	pxm_
黃	wwt_
顯	hna_
罪	zxw_
神	sfi_
藝	rlt_
席	zki_
含	hgo_
企	kzo_
密	mcj_
營	y;f_
項	hwm_
防	fwn_
舉	gxh_
球	kbm_
英	y;t_
勢	slg_
告	guh_
李	lzd_
布	buk_
木	mdd_
輪	lpj_
亞	eam_
朝	cqj_
師	sih_
圍	wlw_
遠	yry_
字	zij_
注	zye_
供	gso_
河	hoe_
態	tvi_
封	fsg_
另	l;r_
復	fdh_
樹	syd_
溶	yse_
止	ziy_
言	yny_
台	tyi_
士	sij_
武	mum_
固	guw_
葉	yzt_
波	boe_
視	sii_
僅	gfo_
降	hwn_
左	zok_
章	zty_
害	hyj_
續	zkv2
試	siy_
充	csy_
兵	b;o_
源	yre_
判	prf_
似	cio_
司	sis_
足	zdr_
練	lnv_
略	lkw_
田	tnw_
犯	fjk_
負	fun_
擊	gkj_
繼	glv_
興	h;h_
堅	gns_
輸	syj_
曲	kdt_
修	sbo_
故	guj_
覺	gph_
夠	gbn_
笑	sqh_
船	srh_
富	fuj_
職	zks_
漢	hee_
畫	wal_
巴	baa_
裡	lxl_
雖	sxr_
板	bjd_
飛	fzn_
佔	zmo_
樂	lpv_
檢	gmd_
吸	kmr_
里	lzw_
助	zob_
陽	ytn_
互	wum_
初	col_
投	tbq_
策	chh_
古	guj2
徑	g;h_
鋼	gwc_
端	dry_
簡	gjh_
升	s;h_
述	soy_
盡	zpl_
帝	dly_
射	seh_
草	cut_
承	s;n_
獨	ddk_
限	hjn_
宣	srj_
雙	sto_
微	mzh_
控	hsq_
州	zbi_
良	lti_
軸	zdj_
否	fbm_
紀	gzv_
依	yio_
頂	d;m_
礎	com_
倒	duo_
房	fwh_
突	dcj_
坐	coo_
粉	fff_
客	hhj_
袁	yrg_
冷	lji_
勝	s;b_
絕	zdv_
析	skd_
劑	zly_
測	che_
絲	siv_
協	hzj_
訴	suy_
陳	cfn_
仍	y;o_
羅	low_
餘	yyo_
洋	yte_
苦	fut_
夜	yey_
移	yih_
模	mud_
混	wfe_
母	muw_
短	dro_
聚	zxs_
汽	hze_
村	crd_
哪	nar_
既	gza_
距	kxr_
校	gnd_
停	t;o_
烈	lim_
央	ytl_
察	ccj_
迅	spy_
境	g;g_
印	yfh_
刻	hqy_
括	ktq_
激	gke_
孔	hsn_
待	dyh_
散	sjt_
侵	cgo_
菜	cyt_
味	mzr_
舊	gbt_
湖	wue_
貨	foo_
彈	tjn_
損	srq_
預	yyn_
阻	zon_
乙	ydn_
穩	wfh_
植	zkd_
媽	mav_
息	skh_
擴	qwq_
酒	zbe_
雲	wfm_
揮	flq_
守	sbj_
拿	nao_
序	zxi_
紙	ziv_
熟	sdy2
雨	yym_
針	zgc_
唱	ctr_
訓	ffy_
誤	rry_
願	hna2
審	sgj_
血	hdh_
茶	cat_
鮮	snn_
糧	ltf_
斤	gfh_
孩	hvn_
肥	fzb_
善	snt_
演	yne_
龍	lsy_
父	fuc_
漸	zme_
歡	frt_
掌	ztf_
械	hvd_
剛	gwb_
盾	tph_
晚	mja_
粒	lmf_
藥	ykt_
魯	lun_
貴	xll_
煤	mxf_
伯	bho_
香	hth_
迫	bky_
培	pxg_
握	ehq_
蘭	ljt_
沉	cge_
假	gao_
執	zmg_
穿	crj_
答	dvh_
順	spl_
煙	ynf_
縮	sdv_
喜	hzg_
腳	gkb_
異	yiw_
免	mnn_
困	qfw_
星	s;a_
福	fdi_
染	yme_
概	kyd_
慢	mjp_
游	yby_
磁	cim_
倍	pxo_
祖	zui_
促	cdo_
靜	z;q_
補	bul_
評	p;y_
鐘	zsc_
肉	ydo_
尼	nzs_
寬	frj_
揚	ytq_
棉	mnd_
希	hzk_
操	cuq_
藏	cwt_
宜	yij_
氫	h;o_
露	lum_
套	tuk_
督	ddy_
筆	bch_
振	zfq_
架	gak_
亮	lty_
慶	h;I_
綠	ldc_
編	pnv_
牛	rbh_
觸	zdn_
雷	lxm_
銷	sqc_
座	zoi_
抓	znq_
裂	lim2
呼	fur_
景	g;a_
威	wli_
晶	z;a_
厚	hbm_
衡	hgh_
延	ynn_
雞	glb_
孫	srn_
危	rln_
沖	cse_
臨	lgs_
陸	ldn_
奇	kzk_
燈	dgf_
歲	sxy_
束	cdd_
耐	nym_
劇	kky_
趙	zqg_
跳	tqr_
哥	gom_
課	foy_
凱	hyu_
額	rhj_
紹	sqv_
殖	zkm_
宗	zsj_
苗	mqt_
弱	ykn_
零	l;m_
岩	rhu_
探	thq_
滑	wce_
鎮	zfc_
飯	fjo_
濃	nse_
航	hwh_
懷	wvp_
趕	geg_
靈	l;m2
賽	cyj_
召	zqs_
歸	xlh_
鼓	gug_
播	boq_
盤	prh_
康	hwi_
錄	ldc2
菌	qft_
純	spv_
橫	wjd_
繫	hlj_
符	fuh_
堂	twf_
槍	ctd_
幅	fdl_
哈	har_
竟	g;y_
澤	zhe_
壤	wvg_
碳	tjm_
遍	pny_
側	zqo_
寨	zvj_
敢	ggm_
慮	lxy_
斜	ceo_
納	nvv_
塞	sqj_
伸	sfo_
濕	sme_
麥	mqj_
荷	hot_
床	cwv_
築	zdh_
戶	wuh_
塔	tvg_
透	tby_
刀	dus_
氯	ldo_
份	ffo_
毒	ddq_
泥	nle_
退	txy_
洗	sle_
蟲	csl_
擺	bvq_
賣	mvg_
耗	huq_
圈	hrw_
夏	ham_
擇	zhq_
忙	mwp_
銅	tsc_
硬	rjm_
卷	grf_
雪	sdm_
亦	yky_
函	hhu_
抽	cbq_
篇	pnh_
陣	zfn_
陰	ygn_
追	zxy_
堆	dxg_
雄	hsk_
盛	s;I_
泛	fje_
爸	bac_
樓	lbd_
避	bzy_
謀	mby_
噸	dpr_
野	yew_
豬	zym_
旗	kzy_
偏	pno_
典	dnt_
索	spj_
潮	cqe_
爺	yec_
忽	fcp_
塑	spt_
遺	wly_
累	lxw_
松	csd_
豆	dbm_
粗	zuh_
傾	k;o_
痛	tsk_
楚	cod_
壁	bks_
謝	zey_
奮	gbt2
購	kbb_
君	xfs_
池	cie_
骨	xcb_
監	ghs_
捕	buq_
胡	wuj_
弟	dlc_
暴	bua_
割	gwj_
殊	sym_
貫	grw_
頓	dpp_
午	rro_
塵	cfi_
聞	mfa_
炮	pnf_
殘	cjm_
橋	kqd_
婦	fuv_
招	zqq_
吳	rrr_
付	fuo_
浮	fbe_
徐	cxh_
您	nzo_
冬	dsh_
搖	yqq_
谷	gdc_
箱	sth_
隔	ghn_
訂	d;y_
吹	cxr_
柱	cyd_
唐	twi_
敗	bvb_
嘴	zxr_
宋	ssj_
玻	lyt_
巨	gxs_
耕	gjq_
坦	tjg_
榮	w;f_
灣	wje_
閉	bla_
鍵	gnc_
剝	mpn_
駐	zys_
救	gbi_
鍋	woc_
凝	y;i_
堿	t;l_
麻	mai_
跡	zkr_
禁	ggd_
廢	fli_
版	bjl_
緩	wrv_
淨	z;e_
睛	c;a_
昌	cta_
婚	ffv_
涉	sze_
筒	tsh_
朗	lwi_
莊	zwt_
街	gvh_
姑	guv_
貿	mbh_
煉	lnf_
慣	xjp_
勻	wfp_
紗	sav_
辯	bny_
彪	bqy_
抵	dlq_
億	yko_
璃	lzm_
秀	sbh_
薩	sct_
俄	roo_
舞	muo_
網	mwv_
店	dmi_
噴	pfr_
洪	hse_
閃	sma_
賀	hok_
柬	gjd_
爆	bnf_
烯	hzf_
勒	lqt_
津	rnk_
勇	ysn_
像	zt3
蒙	mst_
滾	xfe_
芳	fwt_
坡	bog_
腿	txb_
尾	mzs_
蕩	dwt_
冰	b;I_
登	dgn_
鑽	zrc_
秘	bzh_
逃	tuy_
氨	eeo_
郭	xpy_
峰	fsu_
港	gwe_
軌	xlj_
畢	bcw_
擦	ccq_
莫	mpt_
刺	cid_
浪	lwe_
援	wrq_
株	zyd_
股	gub_
泡	pue_
甘	ggt_
睡	sxb_
島	duh_
鑄	zyc_
休	ybo_
牧	mdh_
繞	yqv_
炸	zaf_
磷	lpm_
朋	pgb_
淡	the_
尖	zmf_
陷	hgn_
柴	cvy_
呈	c;r_
徒	tuh_
顏	rjy_
稍	snh_
淚	lxe_
忘	mwy_
泵	bgm_
拖	toq_
洞	dse_
鏡	g;c_
辛	sfy_
鋒	fsc_
貧	pfc_
虛	hxy2
彎	wjv_
泰	tvq_
匯	wxs_
幼	ybv_
尊	zrt_
廷	t;n_
窗	ctj_
綱	gwv_
隸	dld_
疑	yip_
宮	gsj_
震	zfm_
姐	zev_
尤	ybi_
琴	kgm_
循	cph_
描	mqq_
膜	mpb_
腰	yqb_
緣	yrv_
森	sgd_
枝	zid_
溝	kbe_
催	cxo_
憶	ykp_
邦	bwq_
剩	z;h_
欄	ljd_
擁	ysq_
禮	lli_
紋	mfv_
罷	baw_
幸	hgg_
袖	zbl_
喊	hhr_
埃	evg_
勤	kft_
罰	fcw_
潛	cme_
縫	fsv_
姓	s;v_
刊	hem_
畜	cdy_
鋁	lxc_
麗	llm_
跨	qar_
默	mqw_
鏈	lnc_
仿	fwo_
掃	suq_
袋	dyo_
炭	tju_
殼	hpg_
幕	mpt2
弧	wun_
梅	mxd_
舟	zbh_
災	zyv_
潔	gie_
抱	puq_
毀	wlh_
懂	dsp_
寒	hej_
寄	gzj_
屆	gvs_
躍	ykr_
挑	tqq_
渡	due_
丹	djb_
艱	gjt_
貝	bxb_
拔	bcq_
戴	dvj_
碼	mam_
芽	rat_
赤	ckg_
漁	yye_
鉛	yrc_
敬	g;t_
顆	fow_
奔	bfk_
欲	ydc_
柯	eod_
虎	fuy_
稀	hzh_
妹	mxv_
乏	fch_
申	sfl_
桌	cky_
允	wfi_
隆	lsn_
魏	rlh_
倉	cwo_
曉	hqa_
兼	gmt_
氮	dho_
赫	hhg_
牆	ctv_
礙	rym_
忠	zsl_
准	zpi_
肅	sdl_
缸	gwo_
牽	hny_
搶	ctq_
巧	hnm_
博	bpj_
兄	h;r_
杜	dud_
訊	spy2
誠	s;y_
祥	cti_
碧	bkm_
頁	yzm_
巡	cpy_
矩	gxo_
灌	gre_
悲	bzl_
齡	l;y_
倫	lpo_
聖	s;s_
恐	hsm_
恰	hmp_
鄭	z;t_
趣	cxg_
抬	tyq_
柔	ybn_
滴	dke_
猛	mjk_
輛	ltj_
勁	g;m_
妻	clj_
填	tng_
儲	cyo_
淺	cne_
鬧	nnl_
讚	zjy_
吊	dqr_
伐	fco_
療	lqk_
瓶	p;t_
臂	bzs_
婆	poe_
忍	yfs_
蝦	hal_
胸	hsb_
鄰	lpf_
棄	hzy_
擠	zlq_
鋪	puc_
乳	yyb_
槽	cud_
鬆	sss_
仁	yfo_
熔	ysf_
磚	zrm_
租	zuh2
伴	bro_
瓜	xah_
丙	b;m_
暫	zhj_
譜	puy_
秧	gad_
迷	mly_
牌	pvl_
詳	cty_
膽	dhb_
踏	dvr_
呆	ryr_
賓	bfj_
糊	wuf_
洛	lpe_
憤	ffp_
怒	nuv_
粘	nmf_
乃	nvn_
緒	sxv_
輝	flf_
敏	mfo_
熙	hzs_
皆	gvp_
桿	ged_
偵	z;o_
掘	xcq_
享	hty_
糾	gbv_
醒	s;m_
鎖	soc_
牲	lbv_
恨	hfp_
霸	bam_
玩	wj2
陵	l;n_
祝	zdi_
秒	mqh_
役	ykh_
悉	mse_
冒	mua_
鴨	evw_
蠟	lvl_
塗	tue_
鳳	fsh_
晨	sfa_
輩	bxl_
秩	dih_
署	cyw_
卵	lph_
梯	tld_
炎	ymf_
灘	the2
驅	kxs_
篩	slh_
峽	hvu_
壽	sbg_
啥	sar_
浸	zge_
泉	crh_
帽	mul_
硅	xlm_
疆	gtn_
棋	kzd_
貸	tvo_
嫩	nrv_
冠	grb_
牢	luj_
蝕	sio_
奧	euh_
鳴	wur_
嶺	l;u_
串	crl_
融	ysm_
繪	kxv_
盆	prc_
錫	skc_
廟	mqi_
凍	dsi_
攝	szq_
拒	kxq_
僚	lqo_
旱	hea_
眉	mza_
硝	ghb_
扭	nbq_
僑	kqo_
涼	lte_
挺	t;4
碗	wrm_
炒	cnf_
杯	bxd_
患	wjl_
贊	zjh_
豪	huy_
遼	lqy_
勃	btj_
吏	lzj_
旦	dja_
拜	bvh_
狗	gbk_
掩	ymq_
飲	ygo_
搬	brq_
罵	maw_
勾	rbp_
辭	cib_
扣	kbq_
丈	ztj_
估	guo_
絨	ysv_
蔣	ztt_
麵	mnj_
朵	doh_
姆	muv_
擬	yiq_
宇	yyj_
輯	cmj_
雕	dqb_
蓄	cdt_
剪	znt_
崇	ssu_
倡	cto_
薯	syt_
駛	sls_
刷	ccs_
斥	ckh_
賦	fub_
奉	fsq_
漫	mje_
澆	gqe_
鈣	mnj2
桃	tud_
扶	fuq_
仔	zlo_
俗	zdo_
腔	hwb_
鞋	hvt_
悄	cqp_
撞	zw3
覆	fdm_
騙	pns_
週	zby_
勘	hgt_
旺	wwa_
沸	fle_
孤	gun_
黏	nmh_
吐	tur_
渠	kxe_
屈	wcs_
孟	mjn_
仰	yto_
妙	mqv_
辟	pks_
疾	zck_
惜	skp_
狠	hfk_
諧	hvy_
拋	pnq_
喂	wlr_
霉	mxm_
桑	swe_
嘛	mar_
崗	gwu_
髒	zwb_
賴	lvd_
甜	tmh_
閱	yda_
肌	gzb_
烴	g;f_
巷	hwt_
毅	rly_
昨	zpa_
煮	zyj_
症	z;k_
搭	dvq_
釘	d;c_
籠	lsh_
酷	hdm_
鬍	wus_
偷	tbo_
弓	gsn_
錐	zxc_
遊	yby2
坑	hjg_
鼻	bzh2
翼	yks_
敘	zxo_
罐	yqf_
棚	pjd_
抑	ykq_
砌	clm_
蔬	sot_
冶	yei_
枯	fud_
凸	dcb_
紳	xja_
坯	xla_
晉	zpm_
瘦	sbk_
喪	swg_
錠	hqh_
旬	cpp_
鍛	hwl_
邀	yqy_
亭	t;y_
舒	syo_
邁	mvy_
脆	cxb_
憂	ybm_
羽	yys_
漲	zte_
卸	seo_
杭	hwd_
肚	tub_
飄	pqm_
漂	pqe_
搜	sbq_
吾	rrm_
欺	hzt_
昆	xfa_
雅	ram_
飾	sko_
蕭	sqt_
郵	ybh_
遷	cny_
姻	yfv_
赴	fug_
宴	ynj_
債	zvo_
煩	fjf_
帳	ztl_
斑	bjm_
旨	zip_
鈴	l;c_
董	dst_
雛	cop_
傅	cro2
妥	tob_
腹	fdb_
拆	chq_
揉	ybq_
澱	dne_
捅	tsq_
賢	yns_
歪	wvm_
徽	flh_
浩	hue_
胺	eeb_
昂	rwa_
墊	dng_
擋	dwq_
覽	lhs_
貪	tho_
慰	wls_
抹	mcq_
馮	fsi_
樑	ltd_
汪	wwe_
慌	fwp_
姜	gtt_
闆	bja_
劣	ldf_
耀	yqf2
昏	ffh_
躺	twh_
盈	y;n_
攪	gnq_
喬	kqh_
溪	kle_
叢	cst_
譽	yyh_
悶	mra2
屏	p;s_
倆	lto_
悟	rrp_
纜	lhv_
摘	zhq2
頗	pod_
幻	wjv2
柄	b;d_
惠	wlj_
佳	gvo_
臘	lvb_
窩	woj_
宿	sdj_
瞧	cqb_
劍	gmo_
罩	znw_
蔥	cst2
撈	luq_
泊	bpe_
胎	tyb_
湘	ste_
濱	bfe_
砍	hgm_
邵	sqs_
熊	his_
淮	wve_
瘋	fsk_
烘	hsf_
戈	xoi_
檔	dwl_
嫂	suv_
駁	bps_
徙	tuh2
箭	znh_
捐	grq_
嚇	hhr2
撐	cjq_
腸	ctb_
殿	dns_
蓮	lnt_
攤	tjq_
疫	ykk_
堵	dug_
哀	oiy_
沫	mte_
皺	cnp_
暢	ctl_
閣	gpa_
萊	lyt2
疊	dze_
轄	hcj_
壩	bag_
禍	woi_
彭	pjg_
妨	fwv_
艇	t;h_
韋	wld_
柏	phd_
捻	nnq_
漠	mpe_
粹	sxf_
顛	dnj_
仙	sno_
肪	fsh2
押	ecq_
挨	evq_
娃	wav_
拾	tyq2
勿	mcp_
吪	xls_
戀	lrv_
夕	zkn_
鋅	sfc_
篡	sjh_
蓬	pst_
淋	lge_
兆	sql_
釉	ybb_
豈	hzu_
摧	hns_
鈾	ybc_
戚	cki_
嘉	gag_
萌	mgt_
扯	ceq_
舶	y;v_
頒	bjc_
焊	hef_
媳	skv_
肺	flb_
烹	pjy_
疲	pzk_
釀	ytm_
辱	ydm_
狹	hvk_
契	klq_
敦	gnj2
菲	fzt_
韌	yfd_
拳	krf_
醉	zxm_
臥	ros_
竭	kiy_
矣	yii_
茅	mnt_
艷	ymu_
締	dlv_
賬	ztb_
尿	nqs_
渣	zae_
禽	kgo_
履	lzs_
襯	cfl_
賠	pxb_
奸	gjv_
稼	gah_
賊	chb_
醋	cum_
抖	dbq_
晴	c;a2
掀	hnq_
廉	lmi_
褲	ful_
后	hbh_
茫	mwt_
亥	hyy_
攔	ljq_
慧	wlq_
闡	can_
佐	zoo_
孝	hnj_
豎	sys_
麟	npr_
繡	sbc_
挽	wjq_
捨	seq_
逝	sly_
昭	p;p_
肖	cqf_
臭	cbh_
逢	fsy_
芬	fft_
宙	zbj_
堤	tlg_
盲	mjy_
閘	zva_
披	pzq_
鑿	zpt_
拓	tpq_
凶	hsu_
狼	lwk_
幽	ybu_
慎	sfp_
蜂	fsl_
崩	bgu_
綢	cbv_
餐	cjy_
誓	slq_
惟	wlp_
錶	bqc_
叉	cae_
幟	tlv_
芝	zit_
彌	mzn_
慨	kyp_
劫	gzg_
盒	hmo_
卜	bdy_
炳	b;f_
倘	two_
椒	zqd_
閤	wov_
頸	g;m2
巾	gfl_
凌	l;I_
拚	prq_
墾	hfb_
獸	sbr_
蔽	blt_
掙	zjq_
譚	thy_
褐	hwl2
傘	sjo_
翅	cij_
顫	zny_
晃	fwa_
剖	fby_
濁	zde_
湊	cbe_
杰	gid_
霜	stm_
蔑	mit_
礁	zqm_
抄	cnq_
闖	cwa_
碑	bzm_
耶	yes_
刨	pnp_
壺	wug_
柵	bqf_
猜	cvk_
喚	wrr_
樸	ppd_
梳	sod_
玲	cjm2
掏	tuq_
澳	eue_
鋸	gtc_
綿	mnv_
鼠	syh_
膀	bwb_
椅	yid_
穴	ydj_
吵	cnr_
厭	ymm_
呂	lxr_
瞬	spb_
哎	evr_
饒	yqo_
茂	mbt_
蘗	pht_
肝	geb_
籽	zif_
盯	d;b_
菊	gdt_
恥	cis_
濫	lhe_
戒	gvi_
鞭	bnt_
鎂	mzc_
跌	dir_
烤	hnf_
鄂	rpr_
蠻	mjv_
棍	xfd_
鷊	ykm_
云	wfm2
岌	rmu_
嚷	ytr_
藩	fjt_
糟	cud2
匪	fzs_
纏	cnv_
碘	dnm_
悅	ydp_
縛	bpv_
溢	yce_
屠	tus_
甫	pui_
晰	ska_
朽	nbd_
凹	nms_
拱	gsq_
攜	qlq_
迪	dky_
謙	hmy_
嬸	sgv_
盼	pjb_
芒	mwt2
俊	zpo_
唇	spm_
浴	yde_
愚	yyw_
疼	tgk_
岳	rpo_
萎	wlt_
腫	zsb_
絞	gnv_
嫁	gav_
艙	cwh_
蘋	pft_
蠶	chm_
迭	diy_
翁	ysc_
潘	pre_
頃	k;p_
榜	bwd_
欠	hmn_
蹤	zsr_
哼	hgr_
弊	blf_
惑	whi_
悼	dup_
庸	ysi_
迴	wxy_
渦	woe_
嫌	ymv_
聰	css_
贈	zgb_
龐	psi_
鉗	kmc_
廚	cyi_
崖	rvu_
醜	cbm_
籃	lhh_
甸	dnp_
藻	zut_
胖	brb_
并	b;t_
撕	siq_
搗	duq_
詔	zqy_
慈	cit_
炕	hwf_
瓊	k;m_
鏟	cjc_
棵	fod_
饋	xlo_
嬰	y;b_
蒂	dlt_
祭	zlb_
衫	shl_
傑	gio_
瀝	lke_
逸	ycy_
浦	put_
嗓	swr_
暈	wfa_
膏	guy_
艾	rvt_
扮	bjq_
蒲	put2
憐	lnp_
鵝	roh_
淑	sde_
挪	noq_
懼	gxp_
咽	ynr_
驕	gqs_
陡	dbn_
峻	zpu_
惱	nup_
誕	djy_
愉	tbo2
夷	yik_
獵	lzk_
魔	moi_
葛	gwt_
扛	kwq_
蔭	ygt_
銨	eec_
扁	bnh_
杏	hgd_
鑲	stc_
錳	mjc_
橢	tod_
捏	nzq_
郁	ydk_
衍	hnh_
匆	mcp2
傲	ruo_
僵	gto_
燙	twe_
裸	lol_
邪	cem_
攏	lsq_
舅	kbh_
渴	hwe_
坊	fwg_
翔	ctt_
泄	sie_
櫃	xld_
貓	mnb_
廈	hai_
脾	pzb_
噪	cur_
蛇	sel_
晝	wal2
耙	paq_
耿	ggs_
糕	guf_
曇	tha_
辰	sfm_
販	fjb_
哇	war_
扔	y;q_
詐	zay_
悔	fxp_
廓	xpi_
氰	c;o_
肴	rnk2
勺	zkp_
剎	sck_
垮	qag_
罕	heb_
筍	sph_
鍾	zsc2
帕	phl_
恭	gst_
秉	b;h_
摔	soq_
銘	m;c_
齋	zvy_
瘤	lbk_
篷	psh_
藤	tgt_
砸	zvm_
叭	bar_
帆	fjl_
肢	zib_
祼	lol2
拐	xvq_
暑	sya_
瞪	dgb_
笙	sgh_
竿	geh_
酮	tsm_
殲	cmm_
蘊	wft_
瞎	hcb_
藉	zkt_
嵌	hgu_
楔	sid_
紮	zcd_
廂	sti_
撾	woq_
喘	crr_
粵	ydh_
咸	hhi_
拴	sjq_
膝	scb_
腕	wrb_
懇	hfb2
屢	lxs_
熄	skf_
錨	mnc_
愧	qlp_
噹	dwr_
丸	yrk_
圃	buw_
榨	zad_
騷	sus_
蒜	srt_
屯	trp_
毯	thh_
蠋	zdl_
梢	snd_
衙	rah_
鹿	ldi_
弗	fcl_
扒	paq2
灑	sae_
賤	znb_
棕	zsd_
渥	eqe_
泳	w;e_
銜	hhh_
餉	hto_
櫻	y;d_
熬	rng_
擱	gpq_
姨	yiv_
惕	tkp_
鄆	wfb_
綁	bwv_
酥	sum_
寡	xaj_
蚌	pwl_
擅	snq_
拼	p;q_
汰	tve_
鈍	dpc_
雀	zkf_
捆	qfq_
鯉	lzn_
搏	bpq_
鱗	lpn_
賄	kxb_
占	zmy_
戊	mui_
桔	gcd_
怖	bup_
咋	zar_
膩	nzb_
禾	who_
墳	ffg_
煽	snf_
拇	muq_
獅	sik_
寇	kbj_
哄	hsr_
雯	mfm_
喻	yyr_
坪	p;g_
傻	soo_
涅	nze_
跪	xlr_
釗	cqc_
枕	zgd_
侮	fxp2
膛	twb_
寥	lqj_
郝	kpg_
兌	dxc_
曬	sva_
耦	rbq_
鈞	xfc_
匈	hsp_
樁	zwd_
戥	dga_
屁	pzs_
誦	zsy_
抒	syq_
袍	pul_
涵	hhe_
釣	dqc_
嶼	zxu_
虹	hsl_
忿	ffc_
鹹	hhy_
狡	gnk_
蹬	dgr_
燦	cjf_
淒	cle_
嗨	hvr_
笨	bfh_
僧	zgo_
枉	wwd_
嶄	zhu_
棗	zud_
猴	hbk_
焚	ffd_
趟	twg_
咕	gur_
耍	sam_
攬	lhq_
傍	bwo_
爵	zkb_
璋	ztm_
虜	luy_
鍍	duc_
昔	skt_
瞅	cbb_
鑰	ykc_
詭	xly_
惶	wwp_
癌	rhk_
芡	hnt_
軀	kxh_
廬	lui_
煌	wwf_
擰	n;q_
貶	bnb_
滇	tne_
懶	ljp_
炊	cxf_
栓	sjd_
寵	csj_
裙	qfl_
駱	lps_
贛	ggy_
痼	guk_
兜	dbh_
曠	qwa_
噢	eur_
茄	ket_
洴	p;e_
盞	zji_
淆	rne_
濺	zne_
乞	hco_
蜀	sdw_
沛	pxe_
陛	bln_
槐	wvd_
堯	yqg_
冪	mkb_
咒	zbr_
捍	heq_
褂	xal_
煞	scn_
煥	wrf_
叮	d;r_
耽	dhs_
搓	coq_
雹	bpm_
鉻	m;c2
灼	ckf_
鰱	lnn_
嬌	gqv_
躬	gsh_
庶	syi_
蛤	gml_
琳	lgm_
畔	brw_
惹	yet_
鶴	hpj_
皖	wrh_
淫	yge_
卒	zoy_
庵	egi_
繃	bgv_
翹	kqg_
陌	mqn_
簞	djh_
兇	hsu2
膊	bpb_
拂	fcq_
蕉	zqt_
瀾	lje_
贖	sdb_
寅	yfj_
賭	dub_
縷	lbv2
頰	gvk_
魁	fxh_
蛭	zcl_
珊	sjm_
氦	hyo_
蛻	txl_
豌	wrm2
逗	dby_
閨	xla2
襟	kgl_
佃	dno_
侄	zco_
鎳	nzc_
緝	cmv_
乍	zao_
聳	ssh_
噯	oir_
筐	qjh_
瀑	bue_
痴	cik_
靶	bat_
囂	hqr_
唸	nmr_
崔	cxu_
娥	rov_
岔	cac_
撮	cdq_
剿	zqv_
搪	twq_
雍	ysy_
喃	nhr_
琦	kzm_
莉	lzt_
赦	seg_
檐	ymd_
慷	hwp_
豹	pnb_
襪	mcl_
闢	pka_
駿	zps_
喧	hrr_
晤	rra_
舵	toh_
凳	dgn2
媚	mzv_
挾	gvq_
隘	evn_
鰓	syn_
樺	wad_
嚼	zqr_
蠢	cpq_
愣	l;p_
澧	lle_
唆	sor_
弛	cin_
澗	gje_
薪	sft_
懈	hvp_
憎	zgp_
氈	zny2
沼	zqe_
寞	mpj_
眨	bnb2
鑼	loc_
鈕	nbc_
傭	yso_
奢	cek_
腎	sfs_
矯	gqo_
疙	gck_
橙	cjd_
碌	ldm_
澀	gze_
脯	pub_
巍	rlu_
蠅	y;l_
鮑	bnn_
畸	kzw_
磅	bwm_
荔	llt_
厄	ehm_
蕾	lxt_
簇	cdh_
砝	fcm_
羥	ktt_
狄	dkk_
蚜	ral_
垠	rfg_
棺	grd_
帘	lmj_
瞞	mrb_
囚	cbw_
惰	dop_
昧	mxa_
啼	tlr_
怯	hzp_
晌	hta_
婷	t;v_
楣	mzd_
黔	kmw_
僻	pko_
坤	qfg_
鎊	bwc_
怔	z;p_
泮	bre_
溯	sue_
晾	lwa_
睦	mdb_
丫	eac_
蜡	lvl2
陋	lbn_
瀉	see_
窺	qlj_
吶	nvr_
麓	ldd_
悢	ltp_
噓	hxr_
屜	tls_
嗜	sir_
菇	yyt_
臧	zwi_
瑟	scm_
墜	zxn_
饁	yzo_
峨	rou_
熾	cif_
肋	lhs2
剔	tka_
蛹	ysl_
炔	kdf_
鞍	eet_
瑾	gfm_
寢	cgj_
鹼	gjy_
琤	zjm_
臺	tyg_
嗅	cbr_
涯	rve_
癢	ytk_
禪	smi_
蝶	dzl_
楓	fsd_
朴	pqd_
峭	cqu_
蚊	mfl_
稽	klh_
丑	cbn_
庇	bzi_
逞	c;y_
噬	slr_
杖	ztd_
馴	sps_
栩	hxd_
硼	pjm_
鞘	cqt_
犬	hri_
訝	ray_
詠	w;y_
訶	hoy_
歹	dvm_
攫	fpq_
豁	ktj_
磕	hmm_
垢	gbg_
鏵	wac_
傀	fvo_
咧	ler_
渤	bte_
楷	kvd_
啤	ber_
彝	yin_
斂	lmo_
瞻	zmb_
綴	zxv_
筷	fvh_
陀	ton_
汀	d;e_
墮	zxn2
詫	cay_
稟	bfy_
峒	tsu_
碾	nnm_
茸	yst_
券	hrf_
駝	tos_
禿	tdh_
蔔	bht_
崎	kzu_
醚	mlm_
檬	msd_
檸	n;d_
餡	hho_
戔	zni_
苓	l;t_
唾	tor_
瑯	lwm_
鋰	lzc_
穫	wph_
鈦	tvc_
茵	yft_
涕	tle_
逛	xjy_
渭	wle_
炯	x;f_
楠	nhd_
襖	eul_
眶	qjb_
劾	hcy_
洽	hme_
鉑	bpc_
拈	nmq_
蘸	zht_
鋇	bxc_
慚	chp_
奎	fxk_
帖	tzl_
芋	wut_
娟	grv_
乖	xvh_
裘	kbi_
戳	cps_
謗	bwy_
嘯	sqr_
尹	wfs_
渺	mqe_
簿	buh_
篤	ddh_
鯨	k;n_
栗	lom_
汾	ffe_
啃	kgr_
吆	yqr_
哺	bur_
猾	wck_
託	tpy_
隧	sxn_
砧	zgm_
榆	yyd_
廖	lqi_
徘	pxh_
峙	ziu_
湍	cre_
琢	dkm_
阜	fbh_
岑	sgu_
妮	nzv_
毆	ebs_
苔	tyt_
殆	tym_
眺	tqb_
圭	xlg_
熨	tws_
刪	sjb_
睪	ykw_
甄	yfm_
垛	dog_
稜	l;h_
鉬	mdc_
狐	wuk_
灤	lre_
餞	zno_
訣	kdy_
朦	msb_
剁	dkh_
窟	fcj_
叩	kbr_
詹	zmn_
葵	qlt_
碟	dzm_
滄	cwe_
亨	hgy_
壑	kpy_
崽	zlu_
咚	dsr_
靴	htt_
頹	txh_
癱	tjk_
腮	syb_
嚨	lsr_
膿	nsb_
蝸	wol_
誹	fzy_
朧	lsb_
怡	hmp2
褥	ydl_
褶	zzl_
奄	ymk_
猩	s;k_
焙	bxf_
椰	yed_
埂	ggg_
彙	wxv_
鍔	rpc_
鏽	sbc2
絢	hrv_
耑	zru_
颱	tyh_
蹦	bgr_
戮	lds_
淳	spe_
椿	cpd_
嵐	lhu_
撼	hgq_
樊	fjd_
狽	bxk_
幀	z;l_
闓	hya_
呻	sfr_
掂	dmq_
形	y;mh_
麼	moii_
程	c;hg_
資	ziic_
較	gnjk_
規	qlqu_
領	l;oc_
導	duyi_
階	gvna_
油	ybew_
節	zihl_
溫	wfet_
兒	yihu_
商	styr_
率	soyj_
委	wlhv_
素	suqf_
備	bzob_
支	zije_
市	siy2
府	fuii_
值	zkom_
江	gwem_
適	sky2
準	zpij_
價	gaoc_
德	dqhp_
爾	yimk_
氧	ytoq_
材	cydh_
案	eejd_
魚	yynf_
城	s;g2
夫	fuqo_
右	ybkr_
財	cybh_
功	gsms_
雜	zvyg_
致	zimk_
責	zhqc_
環	wjmv_
益	yktt_
優	yboe_
載	zyjj_
鹽	ymst_
友	ybke_
刑	y;mn_
逐	zdyo_
終	zsvy_
衛	wlhn_
燒	sqfu_
洲	zbel_
室	scjg_
甲	gvwl_
久	gbno_
毫	huyu_
醫	yisw_
劉	lbhn_
附	funi_
硫	lbm3
歌	gomo_
攻	gsmk_
討	tuyi_
佈	buob_
燃	ynff_
矛	mnnh_
乎	fuhd_
複	fdle_
介	gvol_
豐	fsut_
弦	ynni_
蛋	djni_
井	z;tt_
皇	wwhg_
翻	fjhm_
踐	cnri_
衣	yiyv_
傷	stoh_
秋	cbhf_
垂	sxhm_
憲	hnjp_
映	y;ak_
居	gxsr_
胞	bnb2
膠	gnbh_
鄉	htvl_
顧	guhc_
措	cuqa_
玉	ydmi_
季	xlhd_
蒸	z;tf_
偉	wloq_
川	crll_
爐	luft_
楊	ytdh_
奏	zbqk_
沿	yrer_
庫	fuij_
奪	ddki_
伊	yiok_
稅	sxhu_
途	tuyd_
裁	cyjv_
險	hmno_
唯	wlrg_
私	sihi_
努	nuvs_
糖	twfr_
干	gemj_
徹	cihk_
庭	t;ig_
于	yymd_
折	ziql_
飼	zior_
瓦	rami_
訪	fwys_
旋	sryo_
遇	yyyb_
彩	cybh2
予	yynn_
削	skfn_
繁	fjof_
丁	d;mn_
迎	y;yl_
館	gror_
秦	cpqd_
脂	ziba_
愈	yyop_
朱	zyhd_
替	tlqa_
纖	cmvm_
尚	stfr_
衝	cshn_
磨	moir_
碎	sxmj_
徵	c;hk_
釋	skhj_
詞	ciyr_
警	g;tr_
綜	zsvf_
遭	zuya_
園	yrwv_
紛	ffvh_
凡	fjhi_
恩	yfwp_
齒	ciyo_
截	zijg_
紡	fwvs_
腐	fuib_
奴	nuve_
乘	s;hp_
恢	fxpf_
梁	lted_
臣	sfs2
脈	mqbv_
縱	zsvo_
寸	crdi_
童	tsyg_
汗	heej_
軋	yyeb_
稻	duhx_
軟	yrjo_
杆	gedj_
厘	lzmg_
儀	yio3
旅	lxyv_
伙	foof_
障	ztnj_
湯	twfr2
亡	mwyv_
幣	blfb_
伏	fdok_
畝	mbyo_
健	gnoq_
售	sbor_
閥	y;yo_
哲	ziqr_
績	zdvc_
授	sbqe_
埔	bug2
壯	zwvg_
佛	fcon_
摩	moiq_
氏	sihp_
瑞	sxmb_
竹	zdhh_
繩	s;vu_
漿	ztve_
貯	cybn_
鈉	bjrq_
濾	lxep_
咱	zaru_
焦	zqof_
伍	rrom_
墨	mqwg_
飽	bnou_
獎	ztvk_
余	yyod_
鬼	xlhi_
污	wues_
勵	llms_
鑒	ghsc_
苯	flfj_
訟	zsy2
智	zioa_
珍	zfmh_
遵	zpy2
螺	lolf_
征	z;h2
隱	yfnp_
桂	xldg_
荒	fwtu_
呵	horr_
撤	ciqk_
舍	seor_
擾	yqqe_
砂	samh_
遞	dlyn_
陶	tunu_
撫	fuqf_
鞏	zoym_
鄧	dgnl_
艦	lhht_
燥	cufd_
橡	ztdo_
柳	lbd2
縴	gkb3
簧	guy3
競	g;yu_
肩	gnhb_
籍	zkha_
誌	ziyp_
爬	pahu_
逆	ykyu_
浙	ziel_
趨	cxgu_
譯	ykyj_
遲	ciyq_
漏	lbeb_
稿	guhb_
芯	sgtp_
叛	brfe_
羊	yttq_
塘	twgr_
酵	hnmd_
輔	fujb_
籌	cbhi_
襲	zvyv_
筋	gfhs_
鉀	gvcl_
漆	ccee_
疏	sonu_
穗	sxhp_
韓	hejq_
栽	zyjd_
餾	hejm_
鴻	hsef_
霧	mums_
陝	lbdw_
番	fjhw_
償	stoc_
廳	t;ip_
曼	mjae_
沈	cgeu_
扇	snhm_
叔	sdye_
脹	ztbv_
衰	sxyv_
棱	l;d2
盜	duit_
滲	sgeh_
曹	cuta_
厲	llmb_
緯	wlvq_
莖	g;tm_
綸	lpvb_
恒	hgpm_
獄	ydk2
逮	dlye_
絡	lpvr_
湧	yses_
膨	pjbh_
寺	zigi_
驟	zns2
穆	mdhh_
焰	ymfx_
犧	hzh2
冊	chbt_
緻	zivk_
壟	lsyg_
錦	ggcb_
欣	yfho_
酯	ybbd_
閒	hjab_
酚	ynvt_
頑	wjmc_
拌	brqq_
仗	ztok_
懲	c;hp_
姚	yqvo_
烷	yrf2
汁	zmej_
燕	lpjq_
撒	ciqk2
醇	spmd_
姿	ziiv_
餅	b;o2
葡	put3
丟	dqhi_
繳	gqvk_
誣	sftj_
盧	luyt_
咨	ziir_
駕	gakf_
擲	zhql_
餌	nzoj_
堡	buog_
仇	sbon_
御	yyh2
滌	dked_
蒼	cwtr_
霞	hame_
酬	cbml_
萄	zkh3
遂	sxyo_
糞	fff2
裕	yylr_
辨	bnyj_
醬	ztvw_
蔡	cytf_
敲	hnye_
痕	hfkv_
鉤	rbcr_
溜	lbew_
玄	yry2
丘	ybom_
曰	ydaa_
邏	loyg_
卿	h;hl_
怨	yrnp_
郊	gnyl_
祿	ldie_
冤	yrbi_
醛	ecmi_
侯	hbok_
魂	wfmi_
捲	grqu_
拘	kxqr_
氟	fco2
頌	zscc_
蹟	zkr2
渾	wfej_
誘	yby2
犁	llhq_
滋	ziei_
猶	ybkw_
舌	sihr_
嘗	stfa_
掠	lkqf_
窄	zhjs_
鴉	eamf_
馳	cisd_
辣	lcyl_
稈	xfcp_
墓	mutg_
葬	zwtt_
躲	dohd_
溉	mihi_
妃	fzvu_
悠	ybop_
佩	pxob_
遙	yqyu_
愁	sbhp_
窯	sbki_
捷	ziqo_
輻	solt_
址	zig2
濤	tuei_
僕	bdoo_
翠	cxs2
饑	gzoi_
寂	zkje_
畏	wlwv_
喉	hbrk_
乾	gejn_
竊	sijb_
謬	mbyh_
儒	yyob_
胚	pxbm_
眠	mnbp_
奈	bnnu_
蓉	ystr_
郡	xfsl_
紐	nbvg_
錘	cxcm_
殷	yfhe_
遮	zeyf_
萍	p;t2
俱	kxoc_
澄	c;et_
雌	ciyg_
閩	mfai_
哨	snrb_
滸	wuej_
俺	ymou_
勳	ffh2
詢	spya_
淀	dneo_
宅	zhjp_
賈	gam2
笛	dkhw_
睜	zjbd_
曆	lkma_
鼎	d;bl_
侍	sio2
穎	w;pc_
氛	ffoh_
卑	bzhj_
堪	hggv_
壇	tjgm_
攀	pjd2
菱	l;te_
艘	sbh2
挫	coqg_
羞	sbtg_
樞	sydr_
餵	wlov_
慕	mutp_
茲	ziti_
豫	yyno_
匠	ztsl_
茬	catg_
胃	wlwb_
沾	zmer_
疇	cbwi_
歧	kzye_
沃	ydek_
桐	tsdr_
潰	kxec_
鵬	pjbf_
蔗	zetf_
潭	thej_
孢	bnnu2
診	cfyh_
梭	sode_
祁	kzil_
貞	z;y2
賜	cibh_
卓	ckyj_
汛	spej_
灶	zufg_
撓	nnqu_
膚	fuy3
侖	lpob_
勉	mnn2
滬	wueu_
蜜	mcji_
贏	y;yc_
孕	yfnd_
兔	tuni_
嚦	lkrm_
謠	yqy2
廊	lwil_
緬	mnvl_
俘	fuod_
腺	snbe_
僱	guog_
脊	zkfb_
滯	zleb_
溴	cbek_
倚	yior_
苛	hot2
鈔	cnch_
斬	zhjl_
氓	mfyp_
鹵	luyi_
窖	gnjr_
欽	ygco_
媒	mxvd_
衷	csjv_
秤	c;h2
粱	lted2
囑	zdri_
宦	wjjl_
杉	chd2
岡	gwbu_
吁	hxrd_
皂	zuhp_
矢	ciok_
寓	yyjb_
瑪	mamf_
瓣	fjyj_
淘	tueu_
桉	#N/A_
鬚	susc_
儉	gmoo_
脖	btbd_
嘩	warj_
刃	yfs2
枚	mxdk_
爪	znho_
娓	mzvu_
忌	gzsp_
荊	g;tn_
轎	kqjb_
壘	lxwg_
啞	earm_
諒	lty2
泌	bzeh_
滔	tuex_
梨	lzhd_
吻	mfrh_
奠	dntk_
乒	b;oh_
聘	p;ss_
冀	kzlc_
尉	wls2
咖	garr_
彥	ynyh_
稠	cbhr_
汝	yyev_
銹	sbcs_
敞	cwfk_
棟	dwd2
謹	gfym_
葫	wut2
塌	tvg2
忉	duph_
謊	fwyu_
龜	xlhu_
嘻	hzrr_
摻	chqh_
坎	hggo_
梗	ggdk_
鷹	y;if_
胳	ghbr_
莽	mwtt_
糠	hwfe_
淵	yrel_
蕊	sgtp2
奕	ykyk_
譬	pzsr_
扼	ehqu_
腥	s;bm_
辮	bny2
戍	syii_
蹄	tlrb_
瞿	kxbg_
倦	grou_
敷	fuik_
嗣	zirr_
蹈	durx_
湜	zkeo_
糙	cufr_
姬	gzvl_
栖	cldw_
辜	gujj_
茨	cito_
翰	hejm2
呱	xaro_
岐	kzue_
澇	lues_
洶	hsek_
祺	kzic_
魄	phhi_
汞	hsme_
嘲	znrb_
贓	zwb2
咐	furi_
歉	hzto_
扳	bjqe_
鄙	pzrl_
聶	nzsj_
襄	styv_
隋	cxnb_
佑	ybor_
謇	gnjr2
憾	hgpp_
猖	ctka_
泣	ymet_
孵	fuh2
絮	sxvf_
曝	buae_
盥	grht_
韻	wfy2
琪	kzmc_
榴	lbdw2
煎	zntf_
鰲	rugf_
唧	zkrl_
吼	hbru_
蜇	ziqi_
巢	cnvd_
噠	dcrq_
鉸	gnck_
昇	s;at_
淹	ymeu_
募	muts_
釜	fucc_
瑰	xlmi_
鄒	zbpl_
荐	zntd_
焉	ynmf_
彰	ztyh_
匙	siap_
淪	lpeb_
禹	yyhi_
邢	y;ml_
斃	blfp_
漬	zke2
竄	crjv_
柜	xld2
巫	mumo_
玫	mxmk_
韃	tctq_
雇	guhg_
綏	sxvv_
躁	curd_
囪	cshk_
稚	zihg_
庚	ggio_
酌	zkmi_
苟	gbtr_
蔓	mjte_
朕	zgbk_
燾	tugf_
桅	wld2
洒	saew_
娶	cxsv_
飪	ygog_
韶	sqyr_
裳	stfv_
靖	z;yb_
蓿	sdta_
鎔	ysc2
繭	gjti_
霖	lgmd_
氘	duol_
虫	csli_
粥	zdnn_
邑	ymru_
吱	zire_
雁	rjmg_
睹	duba_
籲	yyhc_
俞	yyon_
揪	zbqf_
噶	garv_
絹	grvb_
戎	ysij_
磺	wwmc_
薛	sitj_
髓	sxbb_
丞	s;nm_
宛	yrju_
淤	yyey_
嘎	gari_
虐	ykym_
烙	lpfr_
斧	fuc3
姊	zivh_
喳	zarm_
斌	bfym_
筏	fchi_
瑣	somc_
騾	lxsf_
鴕	tohp_
窒	scjg2
爍	skfd_
祇	ziip_
崧	ssui_
棘	gkdb_
旭	ydka_
梆	bwdl_
孰	sdyi_
眯	mlbd_
慾	ydcp_
肘	znb2
簾	lmhc_
婿	slvb_
楞	l;ds_
孜	zink_
虱	scni_
禎	z;ic_
羨	snto_
醞	wfmt_
宵	sqjb_
伎	gzoe_
驢	lxst_
鞠	gdtd_
夥	fown_
牡	mnhg_
蔚	wlti_
餃	gnok_
皿	m;bt_
吭	hgrn_
羧	sote_
竺	zdhm_
妖	yqvk_
碉	dqmr_
阮	yrnu_
飀	lbhw_
熏	ffhf_
閔	mfak_
聾	lsyj_
淌	twer_
朔	sptb_
軒	hnjj_
緞	drve_
禦	yyhf_
赳	gbgl_
抨	p;qj_
併	b;ot_
儡	lxow_
蟹	hvni_
摯	zigq_
憓	wlpp_
蕪	mutf_
紉	yfvi_
漓	lzeb_
哉	zyjr_
跋	bcre_
銼	cocg_
扞	heqj_
嘿	hzrf_
魅	mzhd_
恫	dspr_
摹	mutq_
俠	hmoo_
誅	zyy3
茯	fdtk_
伺	sior_
幢	zwlg_
箋	znhi_
謎	mlyd_
霄	sqmb_
柿	cidb_
毓	ydou_
胥	sxnb_
娛	yyvk_
湝	gvea_
鈷	#N/A2
硒	slmw_
氬	eaom_
棠	twfd_
袱	fdlk_
妝	zwvv_
蓀	srtf_
羿	rlst_
紊	mfy2
彤	tsbh_
禺	yywi_
巰	kbmu_
籮	lohg_
澈	ciek_
箏	zjhd_
鯽	zknl_
埠	bugj_
潺	sjed_
庤	ziii_
踱	dpre_
氡	dsoy_
莎	#N/A3
魷	ybnu_
閻	ymax_
錮	guc2
捂	wuqr_
汆	croe_
筘	kbhr_
嘶	slr2
喓	yqrv_
捄	kbqe_
侈	cion_
芹	kftl_
恍	fwpu_
羲	hzt2
湛	zhev_
翊	ykym2
侶	lxor_
荀	spta_
戩	znmi_
殃	ytmk_
毋	muwh_
恃	cipi_
舜	spbq_
鬱	wcdh_
婉	yrvu_
淬	cxej_
氚	crol_
憩	hzhp_
圜	yrwv2
澡	zued_
嗽	sbro_
痢	lzkn_
駭	hvso_
觜	zxyg_
邱	ybol_
翩	pnh2
沁	sgep_
焯	ckfj_
薇	mztk_
褘	wll2
嘰	gzri_
馱	tosi_
驛	yksj_
痒	ytkq_
膳	snbr_
礬	fjdr_
諫	gjyf_
彬	bfdh_
褙	bxlb_
匝	zvsb_
沂	yiel_
綽	cnvj_
竅	kqjk_
瑛	y;mk_
萱	hrtm_
卉	wljt_
菩	put2
綺	yivr_
酐	gemj2
議	yiyi2
效	hnyk2
京	g;yf2
施	siyd2
範	fjhu2
謂	wlyb2
詩	siyi2
獻	hnyk3
耳	yisj3
貢	gsmc2
采	cybd2
違	wlyq2
珠	zymd3
諸	zyya2
尋	cgsi2
紫	ziyf2
戲	hzyi2
瓷	ciin2
懸	yrbp2
賞	stfc3
貌	mnbu2
彼	bzhe2
脅	hzkb3
輥	ymsb2
屍	sisp2
誼	yiym2
妄	mwyv2
譴	hnyr3
墻	y;bf2
遣	hnyr2
輿	lztt2
杠	sioi2
蘆	zxoe2
喀	bjrq2
帥	sxhb2
諭	yyyn7
肆	sisq2
宰	zyjj2
屑	sisb2
俯	fuoi2
遜	spyf2
諷	fsyi3
眷	grfu2
暮	muta2
鋤	cocs2
薦	zntf2
熒	y;ff2
撰	zjqc2
逾	yyyn3
殳	syhe3
釁	yfhh2
蕕	ybtw2
熹	hzgf2
凰	wwhg2
廙	yiic2
蒴	sptb3
瀆	zkec2
謁	yiyv2
迂	yyyd2
躅	zdri2
魑	cihb3
槳	ztvd2
滍	ziei2
諱	wlyq3
鮒	funi2
碩	skmc2
竣	zpye2
諄	zpyd2
樟	ztdj2
逶	wlyv2
飴	yior3
浚	zpee2
廁	ciin22
髯	ymsb22
恣	ziip2
徭	yqhu2
的	d_
一	y_
是	s_
在	z_
不	b_
了	l_
有	j_
這	v_
個	g_
我	u_
他	t_
會	w_
發	f_
你	n_
才	c_
係	h_
愛	i_
跑	p_
阿	a_
啊	q_
掛	x_
唉	e_
哦	o_
嗯	r_
和	wo_
人	yf_
中	zs_
大	dv_
為	w2
上	s5
國	xp_
以	yi_
要	y4
地	dz_
時	si_
來	l5
用	ys_
生	sj_
到	d3
作	zp_
出	co_
就	z2
分	ff_
對	dx_
成	s;_
可	ho_
年	nn_
動	ds_
同	ts_
也	y3
能	n4
下	ha_
過	xo_
說	sd_
產	cj_
行	hj_
面	mn_
後	hb_
多	do_
定	d;_
學	hp_
法	fc_
所	so_
得	dq_
十	sm_
三	sh_
進	vp_
等	dg_
部	bu_
電	dn_
力	lk_
水	ux_
高	gu_
都	du_
二	ji_
理	lz_
起	hz_
小	s3
長	ct_
實	uc_
加	ga_
兩	lt_
還	w3
當	dw_
使	sl_
點	dm_
從	cs_
業	yz_
本	br_
去	hx_
好	hu_
應	j;_
開	hy_
合	hm_
其	kz_
前	cn_
外	ry_
天	tn_
四	sz_
日	yc_
那	na_
事	ui_
平	p;_
全	cr_
裏	lx_
表	bq_
與	yy_
關	xj_
各	gp_
新	sf_
內	ny_
數	su_
正	z;_
心	sg_
看	he_
又	j3
比	b3
或	wh_
但	dj_
第	dl_
向	ht_
此	ci_
沒	m2
條	tq_
只	zi_
結	gi_
問	mf_
無	mu_
很	hf_
最	zx_
代	dy_
想	st_
五	rr_
入	ym_
次	ii_
品	bf_
活	wt_
及	km_
求	kb_
老	lu_
頭	tb_
邊	bn_
少	s4
圖	tu_
接	zz_
將	zt_
別	bi_
她	ta_
手	sb_
農	ns_
幾	gz_
九	gb_
區	kx_
強	kt_
放	f5
被	bz_
做	zu_
先	sn_
則	zq_
回	wx_
給	km2
處	cy_
光	xw_
七	cc_
壓	ec_
極	gk_
共	gs_
權	kr_
轉	zr_
更	g2
風	fs_
打	da_
白	bh_
速	cd_
花	fa_
場	ct2
真	zf_
萬	mj_
每	mx_
目	md_
達	dc_
走	zb_
鬥	db_
八	bc_
名	m;_
確	kp_
信	sp_
話	wa_
整	v;_
集	zv_
步	bu2
群	qf_
段	dr_
拉	lv_
林	lg_
叫	gq_
裝	zw_
算	sr_
非	fz_
連	ln_
難	nj_
近	kf_
列	li_
團	tr_
太	tv_
寫	se_
快	f3
眼	rj_
王	ww_
片	pn_
卻	kk_
識	uk_
火	fo_
局	gd_
紅	hs_
聽	t;_
該	gy_
鐵	ti_
隨	cx_
死	uz_
講	gw_
呢	ni_
女	nx_
推	tx_
談	th_
望	mw_
批	pl_
落	lp_
幫	bw_
破	po_
排	pv_
減	gh_
怎	zg_
均	xf_
差	ca_
費	fl_
緊	g5
早	z5
服	fd_
食	sk_
護	wu_
某	mb_
黑	hq_
送	ss_
吃	hk_
春	cp_
跟	gf_
曾	cg_
創	cw_
抗	kw_
考	hn_
壞	wv_
未	mz_
換	wr_
留	lb_
站	zh_
錢	in_
副	fu_
令	l;_
請	c;_
超	cq_
讓	yt_
找	zn_
敵	dk_
塊	f4
錯	io_
頻	pf_
念	nm_
靠	kn_
皮	pz_
若	yk_
搞	gn_
核	hc_
吧	ba_
普	pu_
銀	rf_
語	jy_
缺	kd_
嗎	ma_
急	gm_
脫	td_
沙	sa_
獲	wp_
著	zk_
製	zl_
亂	lr_
殺	sc_
寧	n;_
讀	dd_
班	bj_
句	gx_
擔	dh_
誰	s2
臉	lm_
背	bx_
買	mv_
怕	ph_
薄	bp_
末	mz2
娘	nt_
盟	mg_
屋	ed_
掉	d4
呀	ea_
齊	cl_
款	fr_
永	w;_
滅	gh2
蓋	ky_
域	wk_
潤	yp_
腦	nu_
歐	eb_
惡	ep_
暗	eg_
卡	ka_
借	ze_
灰	fx_
尺	ck_
驚	g;_
旁	pw_
托	tp_
寶	uc2
揭	ki_
男	nh_
並	b;_
插	cv_
岸	re_
啦	la_
肯	hg_
黎	ll_
夢	ms_
啟	kl_
扎	zc_
藍	lh_
弄	ls_
怪	xv_
夾	gv_
窮	ks_
牙	ra_
拍	ph2
挖	wc_
喝	hw_
奶	nv_
爹	de_
碰	ps_
哭	hd_
仲	z3
銳	yx_
撥	bt_
票	pq_
騰	tg_
貼	tz_
闊	ft_
摸	mo_
偶	rb_
吉	gc_
爛	lj_
簽	cm_
烏	nq_
暖	nr_
隙	qk_
狂	qw_
憑	pg_
鳥	nq2
添	tm_
棒	pj_
埋	m5
逼	bk_
勸	hr_
咬	rn_
返	fj_
虧	ql_
框	qj_
哩	le_
偽	rl_
嘆	tj_
轟	xg_
撲	pp_
陪	px_
捉	zd_
郎	lw_
諾	np_
騎	ke_
慘	ch_
潑	pt_
霍	fp_
餓	ro_
吞	tf_
矮	el_
歇	hi_
宏	wg_
刮	xc_
匹	pc_
爽	sw_
蹲	dp_
捧	bs_
囊	nw_
吟	rg_
趁	cf_
晒	sv_
誇	qa_
喲	yo_
喇	l2
甩	lc_
踢	tk_
裹	lx2
啡	fe_
咳	kc_
聊	lq_
劈	pk_
迄	rc_
踩	jv_
賺	zj_
揀	gj_
咯	lo_
撇	pi_
墩	df_
唔	mm_
嗚	ma2
箍	ku_
嚙	ri_
匿	nk_
覓	mk_
廿	ja_
呃	eh_
們	mro_
於	yyy_
主	zyy_
工	gsm_
子	zin_
種	zs3
而	yim_
方	fwy_
民	mfr_
經	g;v_
之	zii_
度	dui_
家	gaj_
如	yyv_
化	fao_
自	zih_
物	mch_
現	ynb_
量	lta_
體	tlb_
機	gzd_
重	csh_
把	baq_
性	s;p_
它	taj_
因	yfw_
制	zlh_
由	ybl_
些	sey_
然	ynb2
政	z;m_
社	sei_
義	yit_
相	std_
間	gja_
樣	ytd_
線	snv_
反	fjh_
明	m;2
原	yrj_
利	lzh_
質	zch_
氣	hzo_
道	duy_
命	m;o_
變	bn3
解	gvn_
意	yiy_
建	gnn_
月	yd4
公	gsc_
軍	xfb_
情	c;p_
者	zej_
立	lvy_
已	yis_
通	tsy_
提	tlq_
直	zkj_
題	tla_
黨	dwf_
展	zns_
果	xow_
料	lqf_
象	zto_
員	yrr_
革	ght_
位	wlo_
常	stf_
文	mfy_
總	zsv_
式	ski_
設	ciy_
管	grh_
特	dqh_
件	gno_
基	gzt_
流	lbe_
路	lu5
級	kmv_
山	sju_
統	tsv_
知	zio_
組	zuv_
見	gn3
計	gly_
角	gpn_
期	kzt_
根	gfd_
論	lpy_
運	wfy_
指	ziq_
決	kde_
西	slm_
必	bip_
戰	znr_
任	ygy_
取	cxs_
據	gxq_
調	tqy_
隊	dxn_
南	nhj_
色	skn_
門	mra_
即	zka_
保	buo_
治	zie_
北	bql_
造	zuy_
百	bhm_
熱	sdy_
海	hye_
口	hbr_
東	dsd_
器	hzr_
世	slp_
金	ggc_
增	zgg_
爭	zjb_
濟	zle_
思	siw_
術	soh_
交	gny_
受	sbb_
幹	gej_
聯	lrs_
認	j;j_
六	ldy_
收	sbv_
證	z;y_
改	gy5
清	c;e_
志	zig_
美	mzt_
己	yis2
再	zyo_
單	djr_
切	cip_
教	gnj_
帶	dv2
安	eej_
身	sfh_
車	cej_
例	llo_
務	mun_
具	gxb_
至	zim_
積	zkh_
示	sim_
聲	s;2
報	bug_
完	yrj2
類	lxf_
離	lz3
華	wat_
科	foh_
傳	cro_
張	ztn_
馬	mas_
米	mlf_
採	cyq_
空	hsj_
元	yrm_
況	few_
今	ggo_
土	tug_
許	hxy_
石	skm_
廣	xwi_
且	ceb_
記	gzy_
需	sxm_
研	ynm_
界	gvw_
律	loh_
究	gbj_
觀	grt_
越	ydg_
織	zkv_
影	y;a_
低	dlo_
持	ciq_
音	ygy2
眾	zsw_
系	hlh_
書	sy4
容	ysj_
際	zln_
驗	yms_
斷	trv_
深	sge_
須	sxh_
礦	qwm_
千	cnh_
省	sjf_
技	gzq_
半	brf_
青	c;q_
辦	bjy_
習	zvs_
便	bno_
響	htv_
約	ykv_
般	brh_
史	sil_
感	ggi_
勞	luf_
往	wwh_
酸	srm_
稱	c;h_
克	hqj_
何	hoo_
除	cxn_
消	sqe_
構	kbd_
甚	sgt_
精	z;f_
歷	lkm_
周	zbb_
什	sgo_
號	hur_
族	zdy_
維	wlv_
劃	whl_
選	sry_
標	bqd_
存	crk_
候	hbo_
親	cfy_
毛	muh_
查	cad_
斯	sit_
院	yrn_
型	y;m_
按	eeq_
格	ghd_
養	ytt_
易	yia_
置	ziw_
派	pve_
層	cgs_
始	civ_
狀	zwv_
專	zrj_
育	ydy_
廠	cwi_
參	chi_
屬	sds_
圓	yrw_
包	bnp_
住	zyo2
滿	mre_
縣	yrb_
照	zqa_
輕	h;j_
引	yfn_
細	slv_
嚴	ymr_
底	dli_
首	sbt_
液	yke_
官	grj_
病	b;k_
失	sch_
蘇	sut_
配	pxm_
黃	wwt_
顯	hna_
罪	zxw_
神	sfi_
藝	rlt_
席	zki_
含	hgo_
企	kzo_
密	mcj_
營	y;f_
項	hwm_
防	fwn_
舉	gxh_
球	kbm_
英	y;t_
勢	slg_
告	guh_
李	lzd_
布	buk_
木	mdd_
輪	lpj_
亞	eam_
朝	cqj_
師	sih_
圍	wlw_
遠	yry_
字	zij_
注	zye_
供	gso_
河	hoe_
態	tvi_
封	fsg_
另	l;r_
復	fdh_
樹	syd_
溶	yse_
止	ziy_
言	yny_
台	tyi_
士	sij_
武	mum_
固	guw_
葉	yzt_
波	boe_
視	sii_
僅	gfo_
降	hwn_
左	zok_
章	zty_
害	hyj_
續	zkv2
試	siy_
充	csy_
兵	b;o_
源	yre_
判	prf_
似	cio_
司	sis_
足	zdr_
練	lnv_
略	lkw_
田	tnw_
犯	fjk_
負	fun_
擊	gkj_
繼	glv_
興	h;h_
堅	gns_
輸	syj_
曲	kdt_
修	sbo_
故	guj_
覺	gph_
夠	gbn_
笑	sqh_
船	srh_
富	fuj_
職	zks_
漢	hee_
畫	wal_
巴	baa_
裡	lxl_
雖	sxr_
板	bjd_
飛	fzn_
佔	zmo_
樂	lpv_
檢	gmd_
吸	kmr_
里	lzw_
助	zob_
陽	ytn_
互	wum_
初	col_
投	tbq_
策	chh_
古	guj2
徑	g;h_
鋼	gwc_
端	dry_
簡	gjh_
升	s;h_
述	soy_
盡	zpl_
帝	dly_
射	seh_
草	cut_
承	s;n_
獨	ddk_
限	hjn_
宣	srj_
雙	sto_
微	mzh_
控	hsq_
州	zbi_
良	lti_
軸	zdj_
否	fbm_
紀	gzv_
依	yio_
頂	d;m_
礎	com_
倒	duo_
房	fwh_
突	dcj_
坐	coo_
粉	fff_
客	hhj_
袁	yrg_
冷	lji_
勝	s;b_
絕	zdv_
析	skd_
劑	zly_
測	che_
絲	siv_
協	hzj_
訴	suy_
陳	cfn_
仍	y;o_
羅	low_
餘	yyo_
洋	yte_
苦	fut_
夜	yey_
移	yih_
模	mud_
混	wfe_
母	muw_
短	dro_
聚	zxs_
汽	hze_
村	crd_
哪	nar_
既	gza_
距	kxr_
校	gnd_
停	t;o_
烈	lim_
央	ytl_
察	ccj_
迅	spy_
境	g;g_
印	yfh_
刻	hqy_
括	ktq_
激	gke_
孔	hsn_
待	dyh_
散	sjt_
侵	cgo_
菜	cyt_
味	mzr_
舊	gbt_
湖	wue_
貨	foo_
彈	tjn_
損	srq_
預	yyn_
阻	zon_
乙	ydn_
穩	wfh_
植	zkd_
媽	mav_
息	skh_
擴	qwq_
酒	zbe_
雲	wfm_
揮	flq_
守	sbj_
拿	nao_
序	zxi_
紙	ziv_
熟	sdy2
雨	yym_
針	zgc_
唱	ctr_
訓	ffy_
誤	rry_
願	hna2
審	sgj_
血	hdh_
茶	cat_
鮮	snn_
糧	ltf_
斤	gfh_
孩	hvn_
肥	fzb_
善	snt_
演	yne_
龍	lsy_
父	fuc_
漸	zme_
歡	frt_
掌	ztf_
械	hvd_
剛	gwb_
盾	tph_
晚	mja_
粒	lmf_
藥	ykt_
魯	lun_
貴	xll_
煤	mxf_
伯	bho_
香	hth_
迫	bky_
培	pxg_
握	ehq_
蘭	ljt_
沉	cge_
假	gao_
執	zmg_
穿	crj_
答	dvh_
順	spl_
煙	ynf_
縮	sdv_
喜	hzg_
腳	gkb_
異	yiw_
免	mnn_
困	qfw_
星	s;a_
福	fdi_
染	yme_
概	kyd_
慢	mjp_
游	yby_
磁	cim_
倍	pxo_
祖	zui_
促	cdo_
靜	z;q_
補	bul_
評	p;y_
鐘	zsc_
肉	ydo_
尼	nzs_
寬	frj_
揚	ytq_
棉	mnd_
希	hzk_
操	cuq_
藏	cwt_
宜	yij_
氫	h;o_
露	lum_
套	tuk_
督	ddy_
筆	bch_
振	zfq_
架	gak_
亮	lty_
慶	h;I_
綠	ldc_
編	pnv_
牛	rbh_
觸	zdn_
雷	lxm_
銷	sqc_
座	zoi_
抓	znq_
裂	lim2
呼	fur_
景	g;a_
威	wli_
晶	z;a_
厚	hbm_
衡	hgh_
延	ynn_
雞	glb_
孫	srn_
危	rln_
沖	cse_
臨	lgs_
陸	ldn_
奇	kzk_
燈	dgf_
歲	sxy_
束	cdd_
耐	nym_
劇	kky_
趙	zqg_
跳	tqr_
哥	gom_
課	foy_
凱	hyu_
額	rhj_
紹	sqv_
殖	zkm_
宗	zsj_
苗	mqt_
弱	ykn_
零	l;m_
岩	rhu_
探	thq_
滑	wce_
鎮	zfc_
飯	fjo_
濃	nse_
航	hwh_
懷	wvp_
趕	geg_
靈	l;m2
賽	cyj_
召	zqs_
歸	xlh_
鼓	gug_
播	boq_
盤	prh_
康	hwi_
錄	ldc2
菌	qft_
純	spv_
橫	wjd_
繫	hlj_
符	fuh_
堂	twf_
槍	ctd_
幅	fdl_
哈	har_
竟	g;y_
澤	zhe_
壤	wvg_
碳	tjm_
遍	pny_
側	zqo_
寨	zvj_
敢	ggm_
慮	lxy_
斜	ceo_
納	nvv_
塞	sqj_
伸	sfo_
濕	sme_
麥	mqj_
荷	hot_
床	cwv_
築	zdh_
戶	wuh_
塔	tvg_
透	tby_
刀	dus_
氯	ldo_
份	ffo_
毒	ddq_
泥	nle_
退	txy_
洗	sle_
蟲	csl_
擺	bvq_
賣	mvg_
耗	huq_
圈	hrw_
夏	ham_
擇	zhq_
忙	mwp_
銅	tsc_
硬	rjm_
卷	grf_
雪	sdm_
亦	yky_
函	hhu_
抽	cbq_
篇	pnh_
陣	zfn_
陰	ygn_
追	zxy_
堆	dxg_
雄	hsk_
盛	s;I_
泛	fje_
爸	bac_
樓	lbd_
避	bzy_
謀	mby_
噸	dpr_
野	yew_
豬	zym_
旗	kzy_
偏	pno_
典	dnt_
索	spj_
潮	cqe_
爺	yec_
忽	fcp_
塑	spt_
遺	wly_
累	lxw_
松	csd_
豆	dbm_
粗	zuh_
傾	k;o_
痛	tsk_
楚	cod_
壁	bks_
謝	zey_
奮	gbt2
購	kbb_
君	xfs_
池	cie_
骨	xcb_
監	ghs_
捕	buq_
胡	wuj_
弟	dlc_
暴	bua_
割	gwj_
殊	sym_
貫	grw_
頓	dpp_
午	rro_
塵	cfi_
聞	mfa_
炮	pnf_
殘	cjm_
橋	kqd_
婦	fuv_
招	zqq_
吳	rrr_
付	fuo_
浮	fbe_
徐	cxh_
您	nzo_
冬	dsh_
搖	yqq_
谷	gdc_
箱	sth_
隔	ghn_
訂	d;y_
吹	cxr_
柱	cyd_
唐	twi_
敗	bvb_
嘴	zxr_
宋	ssj_
玻	lyt_
巨	gxs_
耕	gjq_
坦	tjg_
榮	w;f_
灣	wje_
閉	bla_
鍵	gnc_
剝	mpn_
駐	zys_
救	gbi_
鍋	woc_
凝	y;i_
堿	t;l_
麻	mai_
跡	zkr_
禁	ggd_
廢	fli_
版	bjl_
緩	wrv_
淨	z;e_
睛	c;a_
昌	cta_
婚	ffv_
涉	sze_
筒	tsh_
朗	lwi_
莊	zwt_
街	gvh_
姑	guv_
貿	mbh_
煉	lnf_
慣	xjp_
勻	wfp_
紗	sav_
辯	bny_
彪	bqy_
抵	dlq_
億	yko_
璃	lzm_
秀	sbh_
薩	sct_
俄	roo_
舞	muo_
網	mwv_
店	dmi_
噴	pfr_
洪	hse_
閃	sma_
賀	hok_
柬	gjd_
爆	bnf_
烯	hzf_
勒	lqt_
津	rnk_
勇	ysn_
像	zt3
蒙	mst_
滾	xfe_
芳	fwt_
坡	bog_
腿	txb_
尾	mzs_
蕩	dwt_
冰	b;I_
登	dgn_
鑽	zrc_
秘	bzh_
逃	tuy_
氨	eeo_
郭	xpy_
峰	fsu_
港	gwe_
軌	xlj_
畢	bcw_
擦	ccq_
莫	mpt_
刺	cid_
浪	lwe_
援	wrq_
株	zyd_
股	gub_
泡	pue_
甘	ggt_
睡	sxb_
島	duh_
鑄	zyc_
休	ybo_
牧	mdh_
繞	yqv_
炸	zaf_
磷	lpm_
朋	pgb_
淡	the_
尖	zmf_
陷	hgn_
柴	cvy_
呈	c;r_
徒	tuh_
顏	rjy_
稍	snh_
淚	lxe_
忘	mwy_
泵	bgm_
拖	toq_
洞	dse_
鏡	g;c_
辛	sfy_
鋒	fsc_
貧	pfc_
虛	hxy2
彎	wjv_
泰	tvq_
匯	wxs_
幼	ybv_
尊	zrt_
廷	t;n_
窗	ctj_
綱	gwv_
隸	dld_
疑	yip_
宮	gsj_
震	zfm_
姐	zev_
尤	ybi_
琴	kgm_
循	cph_
描	mqq_
膜	mpb_
腰	yqb_
緣	yrv_
森	sgd_
枝	zid_
溝	kbe_
催	cxo_
憶	ykp_
邦	bwq_
剩	z;h_
欄	ljd_
擁	ysq_
禮	lli_
紋	mfv_
罷	baw_
幸	hgg_
袖	zbl_
喊	hhr_
埃	evg_
勤	kft_
罰	fcw_
潛	cme_
縫	fsv_
姓	s;v_
刊	hem_
畜	cdy_
鋁	lxc_
麗	llm_
跨	qar_
默	mqw_
鏈	lnc_
仿	fwo_
掃	suq_
袋	dyo_
炭	tju_
殼	hpg_
幕	mpt2
弧	wun_
梅	mxd_
舟	zbh_
災	zyv_
潔	gie_
抱	puq_
毀	wlh_
懂	dsp_
寒	hej_
寄	gzj_
屆	gvs_
躍	ykr_
挑	tqq_
渡	due_
丹	djb_
艱	gjt_
貝	bxb_
拔	bcq_
戴	dvj_
碼	mam_
芽	rat_
赤	ckg_
漁	yye_
鉛	yrc_
敬	g;t_
顆	fow_
奔	bfk_
欲	ydc_
柯	eod_
虎	fuy_
稀	hzh_
妹	mxv_
乏	fch_
申	sfl_
桌	cky_
允	wfi_
隆	lsn_
魏	rlh_
倉	cwo_
曉	hqa_
兼	gmt_
氮	dho_
赫	hhg_
牆	ctv_
礙	rym_
忠	zsl_
准	zpi_
肅	sdl_
缸	gwo_
牽	hny_
搶	ctq_
巧	hnm_
博	bpj_
兄	h;r_
杜	dud_
訊	spy2
誠	s;y_
祥	cti_
碧	bkm_
頁	yzm_
巡	cpy_
矩	gxo_
灌	gre_
悲	bzl_
齡	l;y_
倫	lpo_
聖	s;s_
恐	hsm_
恰	hmp_
鄭	z;t_
趣	cxg_
抬	tyq_
柔	ybn_
滴	dke_
猛	mjk_
輛	ltj_
勁	g;m_
妻	clj_
填	tng_
儲	cyo_
淺	cne_
鬧	nnl_
讚	zjy_
吊	dqr_
伐	fco_
療	lqk_
瓶	p;t_
臂	bzs_
婆	poe_
忍	yfs_
蝦	hal_
胸	hsb_
鄰	lpf_
棄	hzy_
擠	zlq_
鋪	puc_
乳	yyb_
槽	cud_
鬆	sss_
仁	yfo_
熔	ysf_
磚	zrm_
租	zuh2
伴	bro_
瓜	xah_
丙	b;m_
暫	zhj_
譜	puy_
秧	gad_
迷	mly_
牌	pvl_
詳	cty_
膽	dhb_
踏	dvr_
呆	ryr_
賓	bfj_
糊	wuf_
洛	lpe_
憤	ffp_
怒	nuv_
粘	nmf_
乃	nvn_
緒	sxv_
輝	flf_
敏	mfo_
熙	hzs_
皆	gvp_
桿	ged_
偵	z;o_
掘	xcq_
享	hty_
糾	gbv_
醒	s;m_
鎖	soc_
牲	lbv_
恨	hfp_
霸	bam_
玩	wj2
陵	l;n_
祝	zdi_
秒	mqh_
役	ykh_
悉	mse_
冒	mua_
鴨	evw_
蠟	lvl_
塗	tue_
鳳	fsh_
晨	sfa_
輩	bxl_
秩	dih_
署	cyw_
卵	lph_
梯	tld_
炎	ymf_
灘	the2
驅	kxs_
篩	slh_
峽	hvu_
壽	sbg_
啥	sar_
浸	zge_
泉	crh_
帽	mul_
硅	xlm_
疆	gtn_
棋	kzd_
貸	tvo_
嫩	nrv_
冠	grb_
牢	luj_
蝕	sio_
奧	euh_
鳴	wur_
嶺	l;u_
串	crl_
融	ysm_
繪	kxv_
盆	prc_
錫	skc_
廟	mqi_
凍	dsi_
攝	szq_
拒	kxq_
僚	lqo_
旱	hea_
眉	mza_
硝	ghb_
扭	nbq_
僑	kqo_
涼	lte_
挺	t;4
碗	wrm_
炒	cnf_
杯	bxd_
患	wjl_
贊	zjh_
豪	huy_
遼	lqy_
勃	btj_
吏	lzj_
旦	dja_
拜	bvh_
狗	gbk_
掩	ymq_
飲	ygo_
搬	brq_
罵	maw_
勾	rbp_
辭	cib_
扣	kbq_
丈	ztj_
估	guo_
絨	ysv_
蔣	ztt_
麵	mnj_
朵	doh_
姆	muv_
擬	yiq_
宇	yyj_
輯	cmj_
雕	dqb_
蓄	cdt_
剪	znt_
崇	ssu_
倡	cto_
薯	syt_
駛	sls_
刷	ccs_
斥	ckh_
賦	fub_
奉	fsq_
漫	mje_
澆	gqe_
鈣	mnj2
桃	tud_
扶	fuq_
仔	zlo_
俗	zdo_
腔	hwb_
鞋	hvt_
悄	cqp_
撞	zw3
覆	fdm_
騙	pns_
週	zby_
勘	hgt_
旺	wwa_
沸	fle_
孤	gun_
黏	nmh_
吐	tur_
渠	kxe_
屈	wcs_
孟	mjn_
仰	yto_
妙	mqv_
辟	pks_
疾	zck_
惜	skp_
狠	hfk_
諧	hvy_
拋	pnq_
喂	wlr_
霉	mxm_
桑	swe_
嘛	mar_
崗	gwu_
髒	zwb_
賴	lvd_
甜	tmh_
閱	yda_
肌	gzb_
烴	g;f_
巷	hwt_
毅	rly_
昨	zpa_
煮	zyj_
症	z;k_
搭	dvq_
釘	d;c_
籠	lsh_
酷	hdm_
鬍	wus_
偷	tbo_
弓	gsn_
錐	zxc_
遊	yby2
坑	hjg_
鼻	bzh2
翼	yks_
敘	zxo_
罐	yqf_
棚	pjd_
抑	ykq_
砌	clm_
蔬	sot_
冶	yei_
枯	fud_
凸	dcb_
紳	xja_
坯	xla_
晉	zpm_
瘦	sbk_
喪	swg_
錠	hqh_
旬	cpp_
鍛	hwl_
邀	yqy_
亭	t;y_
舒	syo_
邁	mvy_
脆	cxb_
憂	ybm_
羽	yys_
漲	zte_
卸	seo_
杭	hwd_
肚	tub_
飄	pqm_
漂	pqe_
搜	sbq_
吾	rrm_
欺	hzt_
昆	xfa_
雅	ram_
飾	sko_
蕭	sqt_
郵	ybh_
遷	cny_
姻	yfv_
赴	fug_
宴	ynj_
債	zvo_
煩	fjf_
帳	ztl_
斑	bjm_
旨	zip_
鈴	l;c_
董	dst_
雛	cop_
傅	cro2
妥	tob_
腹	fdb_
拆	chq_
揉	ybq_
澱	dne_
捅	tsq_
賢	yns_
歪	wvm_
徽	flh_
浩	hue_
胺	eeb_
昂	rwa_
墊	dng_
擋	dwq_
覽	lhs_
貪	tho_
慰	wls_
抹	mcq_
馮	fsi_
樑	ltd_
汪	wwe_
慌	fwp_
姜	gtt_
闆	bja_
劣	ldf_
耀	yqf2
昏	ffh_
躺	twh_
盈	y;n_
攪	gnq_
喬	kqh_
溪	kle_
叢	cst_
譽	yyh_
悶	mra2
屏	p;s_
倆	lto_
悟	rrp_
纜	lhv_
摘	zhq2
頗	pod_
幻	wjv2
柄	b;d_
惠	wlj_
佳	gvo_
臘	lvb_
窩	woj_
宿	sdj_
瞧	cqb_
劍	gmo_
罩	znw_
蔥	cst2
撈	luq_
泊	bpe_
胎	tyb_
湘	ste_
濱	bfe_
砍	hgm_
邵	sqs_
熊	his_
淮	wve_
瘋	fsk_
烘	hsf_
戈	xoi_
檔	dwl_
嫂	suv_
駁	bps_
徙	tuh2
箭	znh_
捐	grq_
嚇	hhr2
撐	cjq_
腸	ctb_
殿	dns_
蓮	lnt_
攤	tjq_
疫	ykk_
堵	dug_
哀	oiy_
沫	mte_
皺	cnp_
暢	ctl_
閣	gpa_
萊	lyt2
疊	dze_
轄	hcj_
壩	bag_
禍	woi_
彭	pjg_
妨	fwv_
艇	t;h_
韋	wld_
柏	phd_
捻	nnq_
漠	mpe_
粹	sxf_
顛	dnj_
仙	sno_
肪	fsh2
押	ecq_
挨	evq_
娃	wav_
拾	tyq2
勿	mcp_
吪	xls_
戀	lrv_
夕	zkn_
鋅	sfc_
篡	sjh_
蓬	pst_
淋	lge_
兆	sql_
釉	ybb_
豈	hzu_
摧	hns_
鈾	ybc_
戚	cki_
嘉	gag_
萌	mgt_
扯	ceq_
舶	y;v_
頒	bjc_
焊	hef_
媳	skv_
肺	flb_
烹	pjy_
疲	pzk_
釀	ytm_
辱	ydm_
狹	hvk_
契	klq_
敦	gnj2
菲	fzt_
韌	yfd_
拳	krf_
醉	zxm_
臥	ros_
竭	kiy_
矣	yii_
茅	mnt_
艷	ymu_
締	dlv_
賬	ztb_
尿	nqs_
渣	zae_
禽	kgo_
履	lzs_
襯	cfl_
賠	pxb_
奸	gjv_
稼	gah_
賊	chb_
醋	cum_
抖	dbq_
晴	c;a2
掀	hnq_
廉	lmi_
褲	ful_
后	hbh_
茫	mwt_
亥	hyy_
攔	ljq_
慧	wlq_
闡	can_
佐	zoo_
孝	hnj_
豎	sys_
麟	npr_
繡	sbc_
挽	wjq_
捨	seq_
逝	sly_
昭	p;p_
肖	cqf_
臭	cbh_
逢	fsy_
芬	fft_
宙	zbj_
堤	tlg_
盲	mjy_
閘	zva_
披	pzq_
鑿	zpt_
拓	tpq_
凶	hsu_
狼	lwk_
幽	ybu_
慎	sfp_
蜂	fsl_
崩	bgu_
綢	cbv_
餐	cjy_
誓	slq_
惟	wlp_
錶	bqc_
叉	cae_
幟	tlv_
芝	zit_
彌	mzn_
慨	kyp_
劫	gzg_
盒	hmo_
卜	bdy_
炳	b;f_
倘	two_
椒	zqd_
閤	wov_
頸	g;m2
巾	gfl_
凌	l;I_
拚	prq_
墾	hfb_
獸	sbr_
蔽	blt_
掙	zjq_
譚	thy_
褐	hwl2
傘	sjo_
翅	cij_
顫	zny_
晃	fwa_
剖	fby_
濁	zde_
湊	cbe_
杰	gid_
霜	stm_
蔑	mit_
礁	zqm_
抄	cnq_
闖	cwa_
碑	bzm_
耶	yes_
刨	pnp_
壺	wug_
柵	bqf_
猜	cvk_
喚	wrr_
樸	ppd_
梳	sod_
玲	cjm2
掏	tuq_
澳	eue_
鋸	gtc_
綿	mnv_
鼠	syh_
膀	bwb_
椅	yid_
穴	ydj_
吵	cnr_
厭	ymm_
呂	lxr_
瞬	spb_
哎	evr_
饒	yqo_
茂	mbt_
蘗	pht_
肝	geb_
籽	zif_
盯	d;b_
菊	gdt_
恥	cis_
濫	lhe_
戒	gvi_
鞭	bnt_
鎂	mzc_
跌	dir_
烤	hnf_
鄂	rpr_
蠻	mjv_
棍	xfd_
鷊	ykm_
云	wfm2
岌	rmu_
嚷	ytr_
藩	fjt_
糟	cud2
匪	fzs_
纏	cnv_
碘	dnm_
悅	ydp_
縛	bpv_
溢	yce_
屠	tus_
甫	pui_
晰	ska_
朽	nbd_
凹	nms_
拱	gsq_
攜	qlq_
迪	dky_
謙	hmy_
嬸	sgv_
盼	pjb_
芒	mwt2
俊	zpo_
唇	spm_
浴	yde_
愚	yyw_
疼	tgk_
岳	rpo_
萎	wlt_
腫	zsb_
絞	gnv_
嫁	gav_
艙	cwh_
蘋	pft_
蠶	chm_
迭	diy_
翁	ysc_
潘	pre_
頃	k;p_
榜	bwd_
欠	hmn_
蹤	zsr_
哼	hgr_
弊	blf_
惑	whi_
悼	dup_
庸	ysi_
迴	wxy_
渦	woe_
嫌	ymv_
聰	css_
贈	zgb_
龐	psi_
鉗	kmc_
廚	cyi_
崖	rvu_
醜	cbm_
籃	lhh_
甸	dnp_
藻	zut_
胖	brb_
并	b;t_
撕	siq_
搗	duq_
詔	zqy_
慈	cit_
炕	hwf_
瓊	k;m_
鏟	cjc_
棵	fod_
饋	xlo_
嬰	y;b_
蒂	dlt_
祭	zlb_
衫	shl_
傑	gio_
瀝	lke_
逸	ycy_
浦	put_
嗓	swr_
暈	wfa_
膏	guy_
艾	rvt_
扮	bjq_
蒲	put2
憐	lnp_
鵝	roh_
淑	sde_
挪	noq_
懼	gxp_
咽	ynr_
驕	gqs_
陡	dbn_
峻	zpu_
惱	nup_
誕	djy_
愉	tbo2
夷	yik_
獵	lzk_
魔	moi_
葛	gwt_
扛	kwq_
蔭	ygt_
銨	eec_
扁	bnh_
杏	hgd_
鑲	stc_
錳	mjc_
橢	tod_
捏	nzq_
郁	ydk_
衍	hnh_
匆	mcp2
傲	ruo_
僵	gto_
燙	twe_
裸	lol_
邪	cem_
攏	lsq_
舅	kbh_
渴	hwe_
坊	fwg_
翔	ctt_
泄	sie_
櫃	xld_
貓	mnb_
廈	hai_
脾	pzb_
噪	cur_
蛇	sel_
晝	wal2
耙	paq_
耿	ggs_
糕	guf_
曇	tha_
辰	sfm_
販	fjb_
哇	war_
扔	y;q_
詐	zay_
悔	fxp_
廓	xpi_
氰	c;o_
肴	rnk2
勺	zkp_
剎	sck_
垮	qag_
罕	heb_
筍	sph_
鍾	zsc2
帕	phl_
恭	gst_
秉	b;h_
摔	soq_
銘	m;c_
齋	zvy_
瘤	lbk_
篷	psh_
藤	tgt_
砸	zvm_
叭	bar_
帆	fjl_
肢	zib_
祼	lol2
拐	xvq_
暑	sya_
瞪	dgb_
笙	sgh_
竿	geh_
酮	tsm_
殲	cmm_
蘊	wft_
瞎	hcb_
藉	zkt_
嵌	hgu_
楔	sid_
紮	zcd_
廂	sti_
撾	woq_
喘	crr_
粵	ydh_
咸	hhi_
拴	sjq_
膝	scb_
腕	wrb_
懇	hfb2
屢	lxs_
熄	skf_
錨	mnc_
愧	qlp_
噹	dwr_
丸	yrk_
圃	buw_
榨	zad_
騷	sus_
蒜	srt_
屯	trp_
毯	thh_
蠋	zdl_
梢	snd_
衙	rah_
鹿	ldi_
弗	fcl_
扒	paq2
灑	sae_
賤	znb_
棕	zsd_
渥	eqe_
泳	w;e_
銜	hhh_
餉	hto_
櫻	y;d_
熬	rng_
擱	gpq_
姨	yiv_
惕	tkp_
鄆	wfb_
綁	bwv_
酥	sum_
寡	xaj_
蚌	pwl_
擅	snq_
拼	p;q_
汰	tve_
鈍	dpc_
雀	zkf_
捆	qfq_
鯉	lzn_
搏	bpq_
鱗	lpn_
賄	kxb_
占	zmy_
戊	mui_
桔	gcd_
怖	bup_
咋	zar_
膩	nzb_
禾	who_
墳	ffg_
煽	snf_
拇	muq_
獅	sik_
寇	kbj_
哄	hsr_
雯	mfm_
喻	yyr_
坪	p;g_
傻	soo_
涅	nze_
跪	xlr_
釗	cqc_
枕	zgd_
侮	fxp2
膛	twb_
寥	lqj_
郝	kpg_
兌	dxc_
曬	sva_
耦	rbq_
鈞	xfc_
匈	hsp_
樁	zwd_
戥	dga_
屁	pzs_
誦	zsy_
抒	syq_
袍	pul_
涵	hhe_
釣	dqc_
嶼	zxu_
虹	hsl_
忿	ffc_
鹹	hhy_
狡	gnk_
蹬	dgr_
燦	cjf_
淒	cle_
嗨	hvr_
笨	bfh_
僧	zgo_
枉	wwd_
嶄	zhu_
棗	zud_
猴	hbk_
焚	ffd_
趟	twg_
咕	gur_
耍	sam_
攬	lhq_
傍	bwo_
爵	zkb_
璋	ztm_
虜	luy_
鍍	duc_
昔	skt_
瞅	cbb_
鑰	ykc_
詭	xly_
惶	wwp_
癌	rhk_
芡	hnt_
軀	kxh_
廬	lui_
煌	wwf_
擰	n;q_
貶	bnb_
滇	tne_
懶	ljp_
炊	cxf_
栓	sjd_
寵	csj_
裙	qfl_
駱	lps_
贛	ggy_
痼	guk_
兜	dbh_
曠	qwa_
噢	eur_
茄	ket_
洴	p;e_
盞	zji_
淆	rne_
濺	zne_
乞	hco_
蜀	sdw_
沛	pxe_
陛	bln_
槐	wvd_
堯	yqg_
冪	mkb_
咒	zbr_
捍	heq_
褂	xal_
煞	scn_
煥	wrf_
叮	d;r_
耽	dhs_
搓	coq_
雹	bpm_
鉻	m;c2
灼	ckf_
鰱	lnn_
嬌	gqv_
躬	gsh_
庶	syi_
蛤	gml_
琳	lgm_
畔	brw_
惹	yet_
鶴	hpj_
皖	wrh_
淫	yge_
卒	zoy_
庵	egi_
繃	bgv_
翹	kqg_
陌	mqn_
簞	djh_
兇	hsu2
膊	bpb_
拂	fcq_
蕉	zqt_
瀾	lje_
贖	sdb_
寅	yfj_
賭	dub_
縷	lbv2
頰	gvk_
魁	fxh_
蛭	zcl_
珊	sjm_
氦	hyo_
蛻	txl_
豌	wrm2
逗	dby_
閨	xla2
襟	kgl_
佃	dno_
侄	zco_
鎳	nzc_
緝	cmv_
乍	zao_
聳	ssh_
噯	oir_
筐	qjh_
瀑	bue_
痴	cik_
靶	bat_
囂	hqr_
唸	nmr_
崔	cxu_
娥	rov_
岔	cac_
撮	cdq_
剿	zqv_
搪	twq_
雍	ysy_
喃	nhr_
琦	kzm_
莉	lzt_
赦	seg_
檐	ymd_
慷	hwp_
豹	pnb_
襪	mcl_
闢	pka_
駿	zps_
喧	hrr_
晤	rra_
舵	toh_
凳	dgn2
媚	mzv_
挾	gvq_
隘	evn_
鰓	syn_
樺	wad_
嚼	zqr_
蠢	cpq_
愣	l;p_
澧	lle_
唆	sor_
弛	cin_
澗	gje_
薪	sft_
懈	hvp_
憎	zgp_
氈	zny2
沼	zqe_
寞	mpj_
眨	bnb2
鑼	loc_
鈕	nbc_
傭	yso_
奢	cek_
腎	sfs_
矯	gqo_
疙	gck_
橙	cjd_
碌	ldm_
澀	gze_
脯	pub_
巍	rlu_
蠅	y;l_
鮑	bnn_
畸	kzw_
磅	bwm_
荔	llt_
厄	ehm_
蕾	lxt_
簇	cdh_
砝	fcm_
羥	ktt_
狄	dkk_
蚜	ral_
垠	rfg_
棺	grd_
帘	lmj_
瞞	mrb_
囚	cbw_
惰	dop_
昧	mxa_
啼	tlr_
怯	hzp_
晌	hta_
婷	t;v_
楣	mzd_
黔	kmw_
僻	pko_
坤	qfg_
鎊	bwc_
怔	z;p_
泮	bre_
溯	sue_
晾	lwa_
睦	mdb_
丫	eac_
蜡	lvl2
陋	lbn_
瀉	see_
窺	qlj_
吶	nvr_
麓	ldd_
悢	ltp_
噓	hxr_
屜	tls_
嗜	sir_
菇	yyt_
臧	zwi_
瑟	scm_
墜	zxn_
饁	yzo_
峨	rou_
熾	cif_
肋	lhs2
剔	tka_
蛹	ysl_
炔	kdf_
鞍	eet_
瑾	gfm_
寢	cgj_
鹼	gjy_
琤	zjm_
臺	tyg_
嗅	cbr_
涯	rve_
癢	ytk_
禪	smi_
蝶	dzl_
楓	fsd_
朴	pqd_
峭	cqu_
蚊	mfl_
稽	klh_
丑	cbn_
庇	bzi_
逞	c;y_
噬	slr_
杖	ztd_
馴	sps_
栩	hxd_
硼	pjm_
鞘	cqt_
犬	hri_
訝	ray_
詠	w;y_
訶	hoy_
歹	dvm_
攫	fpq_
豁	ktj_
磕	hmm_
垢	gbg_
鏵	wac_
傀	fvo_
咧	ler_
渤	bte_
楷	kvd_
啤	ber_
彝	yin_
斂	lmo_
瞻	zmb_
綴	zxv_
筷	fvh_
陀	ton_
汀	d;e_
墮	zxn2
詫	cay_
稟	bfy_
峒	tsu_
碾	nnm_
茸	yst_
券	hrf_
駝	tos_
禿	tdh_
蔔	bht_
崎	kzu_
醚	mlm_
檬	msd_
檸	n;d_
餡	hho_
戔	zni_
苓	l;t_
唾	tor_
瑯	lwm_
鋰	lzc_
穫	wph_
鈦	tvc_
茵	yft_
涕	tle_
逛	xjy_
渭	wle_
炯	x;f_
楠	nhd_
襖	eul_
眶	qjb_
劾	hcy_
洽	hme_
鉑	bpc_
拈	nmq_
蘸	zht_
鋇	bxc_
慚	chp_
奎	fxk_
帖	tzl_
芋	wut_
娟	grv_
乖	xvh_
裘	kbi_
戳	cps_
謗	bwy_
嘯	sqr_
尹	wfs_
渺	mqe_
簿	buh_
篤	ddh_
鯨	k;n_
栗	lom_
汾	ffe_
啃	kgr_
吆	yqr_
哺	bur_
猾	wck_
託	tpy_
隧	sxn_
砧	zgm_
榆	yyd_
廖	lqi_
徘	pxh_
峙	ziu_
湍	cre_
琢	dkm_
阜	fbh_
岑	sgu_
妮	nzv_
毆	ebs_
苔	tyt_
殆	tym_
眺	tqb_
圭	xlg_
熨	tws_
刪	sjb_
睪	ykw_
甄	yfm_
垛	dog_
稜	l;h_
鉬	mdc_
狐	wuk_
灤	lre_
餞	zno_
訣	kdy_
朦	msb_
剁	dkh_
窟	fcj_
叩	kbr_
詹	zmn_
葵	qlt_
碟	dzm_
滄	cwe_
亨	hgy_
壑	kpy_
崽	zlu_
咚	dsr_
靴	htt_
頹	txh_
癱	tjk_
腮	syb_
嚨	lsr_
膿	nsb_
蝸	wol_
誹	fzy_
朧	lsb_
怡	hmp2
褥	ydl_
褶	zzl_
奄	ymk_
猩	s;k_
焙	bxf_
椰	yed_
埂	ggg_
彙	wxv_
鍔	rpc_
鏽	sbc2
絢	hrv_
耑	zru_
颱	tyh_
蹦	bgr_
戮	lds_
淳	spe_
椿	cpd_
嵐	lhu_
撼	hgq_
樊	fjd_
狽	bxk_
幀	z;l_
闓	hya_
呻	sfr_
掂	dmq_
形	y;mh_
麼	moii_
程	c;hg_
資	ziic_
較	gnjk_
規	qlqu_
領	l;oc_
導	duyi_
階	gvna_
油	ybew_
節	zihl_
溫	wfet_
兒	yihu_
商	styr_
率	soyj_
委	wlhv_
素	suqf_
備	bzob_
支	zije_
市	siy2
府	fuii_
值	zkom_
江	gwem_
適	sky2
準	zpij_
價	gaoc_
德	dqhp_
爾	yimk_
氧	ytoq_
材	cydh_
案	eejd_
魚	yynf_
城	s;g2
夫	fuqo_
右	ybkr_
財	cybh_
功	gsms_
雜	zvyg_
致	zimk_
責	zhqc_
環	wjmv_
益	yktt_
優	yboe_
載	zyjj_
鹽	ymst_
友	ybke_
刑	y;mn_
逐	zdyo_
終	zsvy_
衛	wlhn_
燒	sqfu_
洲	zbel_
室	scjg_
甲	gvwl_
久	gbno_
毫	huyu_
醫	yisw_
劉	lbhn_
附	funi_
硫	lbm3
歌	gomo_
攻	gsmk_
討	tuyi_
佈	buob_
燃	ynff_
矛	mnnh_
乎	fuhd_
複	fdle_
介	gvol_
豐	fsut_
弦	ynni_
蛋	djni_
井	z;tt_
皇	wwhg_
翻	fjhm_
踐	cnri_
衣	yiyv_
傷	stoh_
秋	cbhf_
垂	sxhm_
憲	hnjp_
映	y;ak_
居	gxsr_
胞	bnb2
膠	gnbh_
鄉	htvl_
顧	guhc_
措	cuqa_
玉	ydmi_
季	xlhd_
蒸	z;tf_
偉	wloq_
川	crll_
爐	luft_
楊	ytdh_
奏	zbqk_
沿	yrer_
庫	fuij_
奪	ddki_
伊	yiok_
稅	sxhu_
途	tuyd_
裁	cyjv_
險	hmno_
唯	wlrg_
私	sihi_
努	nuvs_
糖	twfr_
干	gemj_
徹	cihk_
庭	t;ig_
于	yymd_
折	ziql_
飼	zior_
瓦	rami_
訪	fwys_
旋	sryo_
遇	yyyb_
彩	cybh2
予	yynn_
削	skfn_
繁	fjof_
丁	d;mn_
迎	y;yl_
館	gror_
秦	cpqd_
脂	ziba_
愈	yyop_
朱	zyhd_
替	tlqa_
纖	cmvm_
尚	stfr_
衝	cshn_
磨	moir_
碎	sxmj_
徵	c;hk_
釋	skhj_
詞	ciyr_
警	g;tr_
綜	zsvf_
遭	zuya_
園	yrwv_
紛	ffvh_
凡	fjhi_
恩	yfwp_
齒	ciyo_
截	zijg_
紡	fwvs_
腐	fuib_
奴	nuve_
乘	s;hp_
恢	fxpf_
梁	lted_
臣	sfs2
脈	mqbv_
縱	zsvo_
寸	crdi_
童	tsyg_
汗	heej_
軋	yyeb_
稻	duhx_
軟	yrjo_
杆	gedj_
厘	lzmg_
儀	yio3
旅	lxyv_
伙	foof_
障	ztnj_
湯	twfr2
亡	mwyv_
幣	blfb_
伏	fdok_
畝	mbyo_
健	gnoq_
售	sbor_
閥	y;yo_
哲	ziqr_
績	zdvc_
授	sbqe_
埔	bug2
壯	zwvg_
佛	fcon_
摩	moiq_
氏	sihp_
瑞	sxmb_
竹	zdhh_
繩	s;vu_
漿	ztve_
貯	cybn_
鈉	bjrq_
濾	lxep_
咱	zaru_
焦	zqof_
伍	rrom_
墨	mqwg_
飽	bnou_
獎	ztvk_
余	yyod_
鬼	xlhi_
污	wues_
勵	llms_
鑒	ghsc_
苯	flfj_
訟	zsy2
智	zioa_
珍	zfmh_
遵	zpy2
螺	lolf_
征	z;h2
隱	yfnp_
桂	xldg_
荒	fwtu_
呵	horr_
撤	ciqk_
舍	seor_
擾	yqqe_
砂	samh_
遞	dlyn_
陶	tunu_
撫	fuqf_
鞏	zoym_
鄧	dgnl_
艦	lhht_
燥	cufd_
橡	ztdo_
柳	lbd2
縴	gkb3
簧	guy3
競	g;yu_
肩	gnhb_
籍	zkha_
誌	ziyp_
爬	pahu_
逆	ykyu_
浙	ziel_
趨	cxgu_
譯	ykyj_
遲	ciyq_
漏	lbeb_
稿	guhb_
芯	sgtp_
叛	brfe_
羊	yttq_
塘	twgr_
酵	hnmd_
輔	fujb_
籌	cbhi_
襲	zvyv_
筋	gfhs_
鉀	gvcl_
漆	ccee_
疏	sonu_
穗	sxhp_
韓	hejq_
栽	zyjd_
餾	hejm_
鴻	hsef_
霧	mums_
陝	lbdw_
番	fjhw_
償	stoc_
廳	t;ip_
曼	mjae_
沈	cgeu_
扇	snhm_
叔	sdye_
脹	ztbv_
衰	sxyv_
棱	l;d2
盜	duit_
滲	sgeh_
曹	cuta_
厲	llmb_
緯	wlvq_
莖	g;tm_
綸	lpvb_
恒	hgpm_
獄	ydk2
逮	dlye_
絡	lpvr_
湧	yses_
膨	pjbh_
寺	zigi_
驟	zns2
穆	mdhh_
焰	ymfx_
犧	hzh2
冊	chbt_
緻	zivk_
壟	lsyg_
錦	ggcb_
欣	yfho_
酯	ybbd_
閒	hjab_
酚	ynvt_
頑	wjmc_
拌	brqq_
仗	ztok_
懲	c;hp_
姚	yqvo_
烷	yrf2
汁	zmej_
燕	lpjq_
撒	ciqk2
醇	spmd_
姿	ziiv_
餅	b;o2
葡	put3
丟	dqhi_
繳	gqvk_
誣	sftj_
盧	luyt_
咨	ziir_
駕	gakf_
擲	zhql_
餌	nzoj_
堡	buog_
仇	sbon_
御	yyh2
滌	dked_
蒼	cwtr_
霞	hame_
酬	cbml_
萄	zkh3
遂	sxyo_
糞	fff2
裕	yylr_
辨	bnyj_
醬	ztvw_
蔡	cytf_
敲	hnye_
痕	hfkv_
鉤	rbcr_
溜	lbew_
玄	yry2
丘	ybom_
曰	ydaa_
邏	loyg_
卿	h;hl_
怨	yrnp_
郊	gnyl_
祿	ldie_
冤	yrbi_
醛	ecmi_
侯	hbok_
魂	wfmi_
捲	grqu_
拘	kxqr_
氟	fco2
頌	zscc_
蹟	zkr2
渾	wfej_
誘	yby2
犁	llhq_
滋	ziei_
猶	ybkw_
舌	sihr_
嘗	stfa_
掠	lkqf_
窄	zhjs_
鴉	eamf_
馳	cisd_
辣	lcyl_
稈	xfcp_
墓	mutg_
葬	zwtt_
躲	dohd_
溉	mihi_
妃	fzvu_
悠	ybop_
佩	pxob_
遙	yqyu_
愁	sbhp_
窯	sbki_
捷	ziqo_
輻	solt_
址	zig2
濤	tuei_
僕	bdoo_
翠	cxs2
饑	gzoi_
寂	zkje_
畏	wlwv_
喉	hbrk_
乾	gejn_
竊	sijb_
謬	mbyh_
儒	yyob_
胚	pxbm_
眠	mnbp_
奈	bnnu_
蓉	ystr_
郡	xfsl_
紐	nbvg_
錘	cxcm_
殷	yfhe_
遮	zeyf_
萍	p;t2
俱	kxoc_
澄	c;et_
雌	ciyg_
閩	mfai_
哨	snrb_
滸	wuej_
俺	ymou_
勳	ffh2
詢	spya_
淀	dneo_
宅	zhjp_
賈	gam2
笛	dkhw_
睜	zjbd_
曆	lkma_
鼎	d;bl_
侍	sio2
穎	w;pc_
氛	ffoh_
卑	bzhj_
堪	hggv_
壇	tjgm_
攀	pjd2
菱	l;te_
艘	sbh2
挫	coqg_
羞	sbtg_
樞	sydr_
餵	wlov_
慕	mutp_
茲	ziti_
豫	yyno_
匠	ztsl_
茬	catg_
胃	wlwb_
沾	zmer_
疇	cbwi_
歧	kzye_
沃	ydek_
桐	tsdr_
潰	kxec_
鵬	pjbf_
蔗	zetf_
潭	thej_
孢	bnnu2
診	cfyh_
梭	sode_
祁	kzil_
貞	z;y2
賜	cibh_
卓	ckyj_
汛	spej_
灶	zufg_
撓	nnqu_
膚	fuy3
侖	lpob_
勉	mnn2
滬	wueu_
蜜	mcji_
贏	y;yc_
孕	yfnd_
兔	tuni_
嚦	lkrm_
謠	yqy2
廊	lwil_
緬	mnvl_
俘	fuod_
腺	snbe_
僱	guog_
脊	zkfb_
滯	zleb_
溴	cbek_
倚	yior_
苛	hot2
鈔	cnch_
斬	zhjl_
氓	mfyp_
鹵	luyi_
窖	gnjr_
欽	ygco_
媒	mxvd_
衷	csjv_
秤	c;h2
粱	lted2
囑	zdri_
宦	wjjl_
杉	chd2
岡	gwbu_
吁	hxrd_
皂	zuhp_
矢	ciok_
寓	yyjb_
瑪	mamf_
瓣	fjyj_
淘	tueu_
桉	#N/A_
鬚	susc_
儉	gmoo_
脖	btbd_
嘩	warj_
刃	yfs2
枚	mxdk_
爪	znho_
娓	mzvu_
忌	gzsp_
荊	g;tn_
轎	kqjb_
壘	lxwg_
啞	earm_
諒	lty2
泌	bzeh_
滔	tuex_
梨	lzhd_
吻	mfrh_
奠	dntk_
乒	b;oh_
聘	p;ss_
冀	kzlc_
尉	wls2
咖	garr_
彥	ynyh_
稠	cbhr_
汝	yyev_
銹	sbcs_
敞	cwfk_
棟	dwd2
謹	gfym_
葫	wut2
塌	tvg2
忉	duph_
謊	fwyu_
龜	xlhu_
嘻	hzrr_
摻	chqh_
坎	hggo_
梗	ggdk_
鷹	y;if_
胳	ghbr_
莽	mwtt_
糠	hwfe_
淵	yrel_
蕊	sgtp2
奕	ykyk_
譬	pzsr_
扼	ehqu_
腥	s;bm_
辮	bny2
戍	syii_
蹄	tlrb_
瞿	kxbg_
倦	grou_
敷	fuik_
嗣	zirr_
蹈	durx_
湜	zkeo_
糙	cufr_
姬	gzvl_
栖	cldw_
辜	gujj_
茨	cito_
翰	hejm2
呱	xaro_
岐	kzue_
澇	lues_
洶	hsek_
祺	kzic_
魄	phhi_
汞	hsme_
嘲	znrb_
贓	zwb2
咐	furi_
歉	hzto_
扳	bjqe_
鄙	pzrl_
聶	nzsj_
襄	styv_
隋	cxnb_
佑	ybor_
謇	gnjr2
憾	hgpp_
猖	ctka_
泣	ymet_
孵	fuh2
絮	sxvf_
曝	buae_
盥	grht_
韻	wfy2
琪	kzmc_
榴	lbdw2
煎	zntf_
鰲	rugf_
唧	zkrl_
吼	hbru_
蜇	ziqi_
巢	cnvd_
噠	dcrq_
鉸	gnck_
昇	s;at_
淹	ymeu_
募	muts_
釜	fucc_
瑰	xlmi_
鄒	zbpl_
荐	zntd_
焉	ynmf_
彰	ztyh_
匙	siap_
淪	lpeb_
禹	yyhi_
邢	y;ml_
斃	blfp_
漬	zke2
竄	crjv_
柜	xld2
巫	mumo_
玫	mxmk_
韃	tctq_
雇	guhg_
綏	sxvv_
躁	curd_
囪	cshk_
稚	zihg_
庚	ggio_
酌	zkmi_
苟	gbtr_
蔓	mjte_
朕	zgbk_
燾	tugf_
桅	wld2
洒	saew_
娶	cxsv_
飪	ygog_
韶	sqyr_
裳	stfv_
靖	z;yb_
蓿	sdta_
鎔	ysc2
繭	gjti_
霖	lgmd_
氘	duol_
虫	csli_
粥	zdnn_
邑	ymru_
吱	zire_
雁	rjmg_
睹	duba_
籲	yyhc_
俞	yyon_
揪	zbqf_
噶	garv_
絹	grvb_
戎	ysij_
磺	wwmc_
薛	sitj_
髓	sxbb_
丞	s;nm_
宛	yrju_
淤	yyey_
嘎	gari_
虐	ykym_
烙	lpfr_
斧	fuc3
姊	zivh_
喳	zarm_
斌	bfym_
筏	fchi_
瑣	somc_
騾	lxsf_
鴕	tohp_
窒	scjg2
爍	skfd_
祇	ziip_
崧	ssui_
棘	gkdb_
旭	ydka_
梆	bwdl_
孰	sdyi_
眯	mlbd_
慾	ydcp_
肘	znb2
簾	lmhc_
婿	slvb_
楞	l;ds_
孜	zink_
虱	scni_
禎	z;ic_
羨	snto_
醞	wfmt_
宵	sqjb_
伎	gzoe_
驢	lxst_
鞠	gdtd_
夥	fown_
牡	mnhg_
蔚	wlti_
餃	gnok_
皿	m;bt_
吭	hgrn_
羧	sote_
竺	zdhm_
妖	yqvk_
碉	dqmr_
阮	yrnu_
飀	lbhw_
熏	ffhf_
閔	mfak_
聾	lsyj_
淌	twer_
朔	sptb_
軒	hnjj_
緞	drve_
禦	yyhf_
赳	gbgl_
抨	p;qj_
併	b;ot_
儡	lxow_
蟹	hvni_
摯	zigq_
憓	wlpp_
蕪	mutf_
紉	yfvi_
漓	lzeb_
哉	zyjr_
跋	bcre_
銼	cocg_
扞	heqj_
嘿	hzrf_
魅	mzhd_
恫	dspr_
摹	mutq_
俠	hmoo_
誅	zyy3
茯	fdtk_
伺	sior_
幢	zwlg_
箋	znhi_
謎	mlyd_
霄	sqmb_
柿	cidb_
毓	ydou_
胥	sxnb_
娛	yyvk_
湝	gvea_
鈷	#N/A2
硒	slmw_
氬	eaom_
棠	twfd_
袱	fdlk_
妝	zwvv_
蓀	srtf_
羿	rlst_
紊	mfy2
彤	tsbh_
禺	yywi_
巰	kbmu_
籮	lohg_
澈	ciek_
箏	zjhd_
鯽	zknl_
埠	bugj_
潺	sjed_
庤	ziii_
踱	dpre_
氡	dsoy_
莎	#N/A3
魷	ybnu_
閻	ymax_
錮	guc2
捂	wuqr_
汆	croe_
筘	kbhr_
嘶	slr2
喓	yqrv_
捄	kbqe_
侈	cion_
芹	kftl_
恍	fwpu_
羲	hzt2
湛	zhev_
翊	ykym2
侶	lxor_
荀	spta_
戩	znmi_
殃	ytmk_
毋	muwh_
恃	cipi_
舜	spbq_
鬱	wcdh_
婉	yrvu_
淬	cxej_
氚	crol_
憩	hzhp_
圜	yrwv2
澡	zued_
嗽	sbro_
痢	lzkn_
駭	hvso_
觜	zxyg_
邱	ybol_
翩	pnh2
沁	sgep_
焯	ckfj_
薇	mztk_
褘	wll2
嘰	gzri_
馱	tosi_
驛	yksj_
痒	ytkq_
膳	snbr_
礬	fjdr_
諫	gjyf_
彬	bfdh_
褙	bxlb_
匝	zvsb_
沂	yiel_
綽	cnvj_
竅	kqjk_
瑛	y;mk_
萱	hrtm_
卉	wljt_
菩	put2
綺	yivr_
酐	gemj2
議	yiyi2
效	hnyk2
京	g;yf2
施	siyd2
範	fjhu2
謂	wlyb2
詩	siyi2
獻	hnyk3
耳	yisj3
貢	gsmc2
采	cybd2
違	wlyq2
珠	zymd3
諸	zyya2
尋	cgsi2
紫	ziyf2
戲	hzyi2
瓷	ciin2
懸	yrbp2
賞	stfc3
貌	mnbu2
彼	bzhe2
脅	hzkb3
輥	ymsb2
屍	sisp2
誼	yiym2
妄	mwyv2
譴	hnyr3
墻	y;bf2
遣	hnyr2
輿	lztt2
杠	sioi2
蘆	zxoe2
喀	bjrq2
帥	sxhb2
諭	yyyn7
肆	sisq2
宰	zyjj2
屑	sisb2
俯	fuoi2
遜	spyf2
諷	fsyi3
眷	grfu2
暮	muta2
鋤	cocs2
薦	zntf2
熒	y;ff2
撰	zjqc2
逾	yyyn3
殳	syhe3
釁	yfhh2
蕕	ybtw2
熹	hzgf2
凰	wwhg2
廙	yiic2
蒴	sptb3
瀆	zkec2
謁	yiyv2
迂	yyyd2
躅	zdri2
魑	cihb3
槳	ztvd2
滍	ziei2
諱	wlyq3
鮒	funi2
碩	skmc2
竣	zpye2
諄	zpyd2
樟	ztdj2
逶	wlyv2
飴	yior3
浚	zpee2
廁	ciin2
髯	ymsb2
恣	ziip2
徭	yqhu2
